name	type
Nina Landis	PER
Australian	LOC
Australia	LOC
New York	LOC
Rikky	PER
Rikky and Pete	MISC
Komodo	MISC
Four of a Kind	MISC
Handle with Care	MISC
Embassy	MISC
Prime Time	MISC
The Keepers	MISC
One Summer Again	MISC
MDA	MISC
The Flying Doctors	MISC
Prisoner	MISC
A Country Practice	MISC
The Art and Nature of Acting	MISC
Flinders University Adelaide	ORG
1970s	TIME
Where the Party At	MISC
2001	TIME
American	LOC
Jagged Edge	ORG
Nelly	PER
three weeks	TIME
U.S.	LOC
Billboard Hot 100	MISC
five weeks	TIME
September 15 , 2001	TIME
Alicia Keys	PER
Fallin	MISC
Jennifer Lopez	PER
I 'm Real ( Murder Remix )	MISC
Best Rap/Sung Collaboration	MISC
44th Grammy Awards	MISC
2002	TIME
Eve and Gwen Stefani	ORG
Let Me Blow Your Mind	MISC
Ivy League public policy schools	ORG
Ivy League	ORG
Bachelor of Arts	MISC
Master of Public Policy	MISC
MPA	MISC
Master of International Affairs	MISC
Doctor of Philosophy	MISC
Princeton University	ORG
1930	TIME
School of Public and International Affairs	ORG
Woodrow Wilson	PER
Harvard University	ORG
Graduate School of Public Administration	ORG
1936	TIME
Yale University	ORG
Jackson Institute for Global Affairs	ORG
2010	TIME
Oxford University	ORG
Blavatnik School of Government	ORG
Europe	LOC
Public Policy	MISC
Blavatnik School	ORG
Bergqvist	PER
6 October 1962	TIME
Stockholm	LOC
Sweden	LOC
1984	TIME
Synthpop	MISC
Shanghai	LOC
two	NUM
Ballerina	MISC
Kee Marcello	PER
Harpo	PER
1987	TIME
2015	TIME
Tracks of Sweden	MISC
Simon Johansson	PER
Michael Duane " Bo " McLaughlin	PER
October 23 , 1953	TIME
Major League Baseball	ORG
1976	TIME
1982	TIME
Houston Astros	ORG
Atlanta Braves	ORG
Oakland Athletics	ORG
May 26	TIME
Chicago White Sox	ORG
Harold Baines	PER
five	NUM
Oakland	LOC
Merritt Hospital	LOC
September	TIME
A 's	ORG
Minors	ORG
1983	TIME
three	NUM
Triple - A	MISC
Chicago Cubs	ORG
Baltimore Orioles	ORG
Rockies	ORG
Abraham Lincoln Bicentennial Foundation	ORG
Abraham Lincoln Bicentennial Commission	ORG
Congress	ORG
Abraham Lincoln	PER
2009	TIME
April 30, 2010	TIME
five - year	TIME
American Civil War	MISC
Alton	LOC
Mississippi River	LOC
Madison County	LOC
Illinois	LOC
United States	LOC
Greater St. Louis	LOC
Missouri	LOC
27,865	NUM
Metro - East	LOC
Miles Davis	PER
Robert Wadlow	PER
Stephen Douglas	PER
October 1858	TIME
12,000	NUM
Confederate	ORG
Alfredo Toro Hardy	PER
Caracas	LOC
May 22 , 1950	TIME
Venezuelan	LOC
Venezuela	LOC
Washington	LOC
London	LOC
Madrid	LOC
Brasilia	LOC
Parag Khanna	PER
Kishore Mahbubani	PER
12 %	NUM
West	LOC
88%	NUM
British	LOC
Robert Harvey	PER
Toro Hardy	PER
Latin America	LOC
Cambridge University	ORG
Geoffrey Hawthorn	PER
Gabrielle Colonna-Romano	PER
1888	TIME
1981	TIME
French	LOC
Comédie - Française	ORG
1913	TIME
Sarah Bernhardt	PER
Symbolist	MISC
Saint - Pol - Roux	MISC
Pierre Renoir	PER
Auguste Renoir	PER
Jeune femme à la rose	MISC
England	LOC
Marie Bell	PER
Conservatoire	ORG
Alfred Edwards	PER
Pierre Alcover	PER
Alcover	PER
Rueil-Malmaison cemetery	LOC
Paris	LOC
Antara Gange	LOC
Shathashrunga	LOC
Indian	LOC
Karnataka	LOC
Kolar	LOC
Kannada	MISC
two miles	NUM
seventy kilometers	NUM
Bangalore	LOC
Sri Kashi Vishweshwara temple	LOC
Shiva	PER
Basava	PER
3-4 km	NUM
seven	NUM
Therhalli	LOC
Connecticut River Walk	LOC
Springfield	LOC
Massachusetts	LOC
New England	LOC
Connecticut River	LOC
3.7 miles	NUM
Chicopee	LOC
South End Bridge	LOC
Naismith Memorial Basketball Hall of Fame	LOC
Knowledge Corridor	MISC
Interstate 91 - a	LOC
1960s	TIME
David Livingstone	PER
Sky Sports	ORG
UK	LOC
the 1970s	TIME
Scottish Television	ORG
BSkyB	ORG
1990	TIME
Sky	ORG
Premier League	ORG
1992	TIME
PGA Tour	ORG
Livingstone	ORG
eight	NUM
2018 Ryder Cup	MISC
Butch Harmon	PER
Nick Dougherty	PER
Sky Sports Golf	MISC
23 years	TIME
Japan	LOC
Dai Nippon Sugar Manufacturing Co.	ORG
Nitto Chemical Industry Co.	ORG
Hideki Tōjō	PER
1944	TIME
World War II	MISC
Fujiyama	PER
three years	TIME
1951	TIME
UNESCO	ORG
Parliament	ORG
1957	TIME
60	TIME
United Nations	ORG
U.S .– Japan Security Treaty	MISC
1960	TIME
China	LOC
Economic Planning Agency	ORG
Millennium	MISC
English	LOC
Robbie Williams	PER
1998	TIME
I 've Been Expecting You	MISC
UK Singles Chart	MISC
the United States	LOC
Canada	LOC
1999	TIME
The Ego Has Landed	MISC
John Barry	PER
You Only Live Twice	MISC
1967	TIME
James Bond	PER
Hatoyama	PER
2 February 1884	TIME
29 January 1946	TIME
Japanese	LOC
Kazuo Hatoyama	PER
House of Representatives of Japan	ORG
Meiji era	TIME
Ichirō Hatoyama	PER
the 1930s	TIME
40s	TIME
Tokyo Imperial University	ORG
1908	TIME
France	LOC
Germany	LOC
1916	TIME
1926	TIME
Sakae Wagatsuma	PER
1910	TIME
Izotaro Suehiro	PER
German	LOC
Anglican Church	ORG
St. Barnabas ' Church	LOC
Ushigome	LOC
Order of Karađorđe 's Star	MISC
Serb	LOC
Kingdom of Serbia	LOC
Balkan Wars	MISC
World War I	MISC
Kingdom of Yugoslavia	LOC
Yugoslavia	LOC
Axis	ORG
Josip Broz Tito	PER
Order of the People's Hero	MISC
Serbian Government	ORG
Cold War	MISC
Karađorđević	PER
Novak Djokovic	PER
February 2012	TIME
1.2   km	NUM
Bolshaya Neva	LOC
Vasilievsky Island	LOC
Saint Petersburg	LOC
Russia	LOC
Spit	LOC
Palace Bridge	LOC
Blagoveshchensky Bridge	LOC
1805	TIME
1810	TIME
1831	TIME
1834	TIME
the 1850s	TIME
1850s	TIME
Petrine Baroque	LOC
early 18th century	TIME
Kunstkamera	LOC
Twelve Collegia	LOC
Menshikov Palace	LOC
Academy of Arts	ORG
Isaakiyevsky Pontone Bridge	LOC
1819	TIME
1841	TIME
Senate Square	LOC
Saint Petersburg State University	ORG
Russian Academy of Sciences	ORG
Peter the Great Museum of Anthropology	ORG
Zoological Museum	LOC
1887	TIME
Sidi Saiyyed Mosque	LOC
Sidi Saiyyid ni Jali	LOC
1572-73 AD	TIME
Hijri year 980	TIME
Ahmedabad	LOC
Gujarat	LOC
India	LOC
Sidi Saiyyid	PER
Bilal Jhajar Khan	PER
Shams - ud - Din Muzaffar Shah III	PER
Gujarat Sultanate	LOC
ten	NUM
Sidi Saiyyed Jali	MISC
Indian Institute of Management Ahmedabad	ORG
Mughals	ORG
லீ சியன் லூங்	PER
Tamil	LOC
10 February 1952	TIME
Singaporean	LOC
2004	TIME
People's Action Party	ORG
Goh Chok Tong	PER
2006	TIME
2011	TIME
15 January 2016	TIME
Singapore 's 13th Parliament	MISC
Lee Kuan Yew	PER
Trinity College	ORG
1974	TIME
Harvard	ORG
Kennedy School of Government	ORG
1971	TIME
Singapore Armed Forces	ORG
Trade and Industry	ORG
Finance and Deputy	ORG
Burkina Faso–Sweden Friendship Association	ORG
Swedish	LOC
Burkina Faso	LOC
West Africa	LOC
120	NUM
one	NUM
Burkinakontakt	MISC
1986	TIME
Thomas Sankara	PER
15 October 1987	TIME
Blaise Compaoré	PER
2012	TIME
2014	TIME
parrandas	MISC
the 18th century	TIME
Las Villas	LOC
Villa Clara	LOC
Sancti Spíritus	LOC
Ciego de Ávila	LOC
Cuba	LOC
Puerto Rican	LOC
Remedios	LOC
Camajuaní	LOC
Vueltas	LOC
Zulueta	LOC
Chambas	LOC
Guayos	LOC
El Santo	LOC
Taguayabón	LOC
Buenavista	LOC
Calabazar de Sagua	LOC
Zaza del Medio	LOC
Falcón	LOC
Puerto Rico	LOC
asaltos	MISC
Christmas	MISC
Carlo Giuseppe Ratti	PER
1737	TIME
1795	TIME
Italian	LOC
Baroque	MISC
Giovanni Agostino Ratti	PER
Savona	LOC
Rome	LOC
Anton Raphael Mengs	PER
Pompeo Batoni	PER
Genoa	LOC
Raffaele Soprani	PER
Genoese	LOC
Vite de ' pittori , scultori ed architetti genovesi	MISC
1769	TIME
Annunciation	MISC
Santa Maria delle Vigne	LOC
A Life of Rafael Mengs	MISC
Notices of Correggio	MISC
Luigi Lanzi	PER
Liguria	LOC
Storia Pittorica dell'Italia	MISC
Pius VI	PER
Accademia Ligustica di Belle Arti	ORG
Raimondo Ghelli	PER
Emmanuel Joseph Sieyès	PER
3 May 1748	TIME
20 June 1836	TIME
Roman Catholic	ORG
French Revolution	MISC
French Consulate	LOC
First French Empire	LOC
1789	TIME
What is the Third Estate	MISC
Revolution	MISC
Estates - General	MISC
National Assembly	ORG
1799	TIME
18	NUM
9 November	TIME
Napoleon Bonaparte	PER
Conner	PER
2 June 1919	TIME
5 November 1998	TIME
United States Army	ORG
Second World War	MISC
Distinguished Service Cross	MISC
four	NUM
Silver Stars	MISC
Croix de guerre	MISC
Italy	LOC
Medal of Honor	MISC
22 years	TIME
29 March 2018	TIME
White House	LOC
Trump	PER
Pauline Conner	PER
East Room	LOC
Big Star 's Third	MISC
Big Star	ORG
1975	TIME
Third/Sister Lovers	MISC
December 2010	TIME
two dozen	NUM
Cat 's Cradle	LOC
Carrboro	LOC
North Carolina	LOC
Jody Stephens	PER
Mike Mills	PER
R.E.M.	ORG
Chris Stamey	PER
The dB 's	ORG
Mitch Easter	PER
Let's Active	ORG
Battle of Talas	MISC
Battle of Talas River	MISC
Battle of Artlakh	MISC
Arab Abbasid Caliphate	ORG
Tibetan Empire	ORG
Chinese Tang dynasty	ORG
Xuanzong	PER
July 751 CE	TIME
Tang	ORG
Talas River	LOC
Syr Darya	LOC
central Asia	LOC
Karluks	ORG
Abbasids	ORG
Muslim	ORG
Transoxiana	LOC
400 years	TIME
Silk Road	MISC
Chinese	LOC
Middle East	LOC
Monumental Church	LOC
Episcopal	ORG
1224 E. Broad Street	LOC
N. 12th	LOC
College Streets	LOC
Richmond	LOC
Virginia	LOC
Robert Mills	PER
America	LOC
Greek Revival	MISC
National Register of Historic Places	MISC
National Historic Landmark	MISC
Court End	LOC
1812	TIME
1814	TIME
72	NUM
December 26, 1811	TIME
Richmond Theatre	LOC
Return of Saturn	MISC
No Doubt	ORG
April 11, 2000	TIME
Trauma Records	ORG
Interscope Records	ORG
Eric Stefani	PER
1994	TIME
two and a half years	TIME
Tragic Kingdom	MISC
Glen Ballard	PER
two years	TIME
Gwen Stefani	PER
Billboard 200	MISC
43rd Grammy Awards	MISC
Best Rock Album	MISC
Be Without You	MISC
Mary J. Blige	PER
Johnta Austin	PER
Bryan Michael Cox	PER
Jason Perry	PER
The Breakthrough	MISC
Ron Fair	PER
2005	TIME
US	LOC
RIAA	ORG
2007	TIME
March 2017	TIME
Billboard Magazine	ORG
R&B;/Hip - Hop Song	MISC
Record of the Year and Song of the Year	MISC
Best R&B ; Song	MISC
Best Female R&B	MISC
Vocal Performance	MISC
2007 Grammy Awards	MISC
Wulsbüttel	LOC
Cuxhaven	LOC
Lower Saxony	LOC
1 January 2014	TIME
Hagen i m Bremischen	LOC
Prince - Archbishopric	LOC
Bremen	LOC
1180	TIME
1648	TIME
Duchy of Bremen	LOC
Danish	LOC
1712	TIME
1715	TIME
Hanoverian Crown	ORG
1807	TIME
Kingdom of Westphalia	LOC
Duchy	LOC
1813	TIME
Electorate of Hanover	LOC
Kingdom of Hanover	LOC
Ducal	LOC
Stade Region	LOC
1823	TIME
Badulla	LOC
Uva Province	LOC
Sri Lanka	LOC
2,861   km²	NUM
837,000	NUM
Monaragala	LOC
Rathnapura	LOC
Ampara	LOC
Kandy	LOC
Nuwara Eliya	LOC
Matale	LOC
Joos van der Beke	PER
1485	TIME
1540/1541	TIME
Antwerp	LOC
1511	TIME
1540	TIME
Netherlandish	LOC
Renaissance	MISC
Guild of Saint Luke of Antwerp	ORG
sixteenth century	TIME
Cornelis van Cleve	PER
1520	TIME
1567	TIME
mad Cleef	PER
Anahita Temple	LOC
Iran	LOC
Anahita	PER
Kangāvar	LOC
Kermanshah Province	LOC
Bishapur	LOC
Kangavar	LOC
Hellenistic	LOC
Persian architectural	MISC
200 m	NUM
Achaemenid	ORG
Apadana Palace	LOC
Persepolis	LOC
Iranian	LOC
Khurra	LOC
Markazi Province	LOC
Official Charts Company	ORG
John Travolta	PER
Olivia Newton-John	PER
Grease	MISC
the 20th century	TIME
the early 21st century	TIME
10 September 2015	TIME
Norodom Suramarit	PER
6 March 1896	TIME
3 April 1960	TIME
Cambodia	LOC
1955	TIME
Norodom Sihanouk	PER
Norodom Sihamoni	PER
Phnom Penh	LOC
Norodom Sutharot	PER
Sisowath Monivong	PER
Sisowath	PER
Sisowath Kosamak	PER
1941	TIME
1993	TIME
Millionaire's Row	LOC
George Town	LOC
Penang	LOC
Malaysia	LOC
Gurney Drive	LOC
Farquhar Street	LOC
1990s	TIME
Central Business District	LOC
North Beach	LOC
Francis Light	PER
Old Protestant Cemetery	LOC
Europeans	ORG
BBC Weather	MISC
BBC News	ORG
BBC World News	ORG
BBC Red Button	ORG
BBC Radio	ORG
BBC Breakfast	ORG
Middlesex Polytechnic	ORG
1988	TIME
Children 's BBC	ORG
Winter Olympics	MISC
Lillehammer	LOC
Central Television	ORG
LBC	ORG
UK Weather Channel	MISC
1996	TIME
BBC	ORG
April 1998	TIME
Trading Up	MISC
BBC One	ORG
Countryfile	MISC
Mr. Hankey , the Christmas Poo	MISC
South Park	LOC
Comedy Central	ORG
December 17, 1997	TIME
Jewish	ORG
Kyle	PER
Hankey	PER
Trey Parker	PER
Matt Stone	PER
Peanuts Christmas	MISC
A Charlie Brown Christmas	MISC
1965	TIME
Kenny	PER
4.5 million	NUM
Nielsen rating	MISC
A Lonely Jew on Christmas	MISC
Kyle 's Mom is a Big Fat Bitch	MISC
John Kricfalusi	PER
The Ren & Stimpy Show	MISC
Erlenmeyer	PER
11 July 1822	TIME
9 August 1877	TIME
Wiesbaden	LOC
Marburg	LOC
Bonn	LOC
Berlin	LOC
University of Bonn	ORG
Karl Wilhelm Wutzer	PER
1863	TIME
University of Berlin	ORG
Jacobi	PER
1777	TIME
1858	TIME
Siegburg	LOC
1848	TIME
Bendorf bei Koblenz	LOC
Asyl für Gehirn- und Nervenkranke	LOC
1866	TIME
Albrechtshöhe	LOC
1867	TIME
1854	TIME
Deutsche Gesellschaft für Psychiatrie und gerichtliche Psychologie	ORG
Friedrich Albrecht Erlenmeyer	PER
1849	TIME
Savoy Truffle	MISC
Beatles	ORG
1968	TIME
The Beatles	MISC
George Harrison	PER
Eric Clapton	PER
Mackintosh 's Good News	MISC
While My Guitar Gently Weeps	MISC
Cream	ORG
Badge	MISC
five - month	TIME
Chris Thomas	PER
Ob - La - Di , Ob - La - Da	MISC
Ian MacDonald	PER
Daryl Easlea	PER
BBC Music	ORG
Ella Fitzgerald	PER
Terry Manning	PER
They Might Be Giants	ORG
Good Life	MISC
The Braxtons	ORG
Toni Braxton	PER
Towanda	PER
Trina	PER
Traci Braxton	PER
Tamar Braxton	PER
Klarmann/Weber	ORG
Arista	ORG
1989	TIME
Family	MISC
Billboard Hot Black Single	MISC
L.A. Reid	PER
Babyface	PER
LaFace Records	ORG
So Many Ways	MISC
Atlantic Records	ORG
The Essential Toni Braxton	MISC
Sherman Island	LOC
Sacramento-San Joaquin River Delta	LOC
Sacramento County	LOC
California	LOC
two kilometres	NUM
Antioch	LOC
Sacramento-	LOC
Solano-	LOC
Contra Costa - Counties	LOC
Sacramento River	LOC
Three Mile Slough	LOC
San Joaquin River	LOC
California State Route 160	LOC
Antioch Bridge	LOC
Three Mile Slough Bridge	LOC
Brannan Island State Recreation Area	LOC
Sherman Lake	LOC
Obliteration Pie	MISC
Robyn Hitchcock	PER
six	NUM
Madonna Of The Wasps	MISC
My Wife And My Dead Wife	MISC
Lipps Inc.	ORG
Funkytown	MISC
I Often Dream Of Trains	MISC
The Man With The Lightbulb Head	MISC
mid-1980s	TIME
Got ta Let This Hen Out	MISC
David Tod	PER
February 21 , 1805	TIME
1868	TIME
Ohio	LOC
Tod	PER
Democrat	ORG
Republicans	ORG
War Democrats	ORG
two - year	TIME
Me Musical Nephews	MISC
1942	TIME
Seymour Kneitel	PER
Tom Johnson	PER
George Germanetti	PER
Popeye	PER
Pipeye	PER
Poopeye	PER
Pupeye	PER
Peepeye	PER
Jack Mercer	PER
Riot in Rhythm	MISC
1950	TIME
Sammy Timberg	PER
Winston Sharples	PER
Swee'Pea	PER
William Stuart Reyburn	PER
December 17 , 1882	TIME
July 25 , 1946	TIME
Republican	ORG
U.S. House of Representatives	ORG
Pennsylvania	LOC
Philadelphia	LOC
John E. Reyburn	PER
Margretta	PER
Georgie Fontaine Maury	PER
June 10, 1911	TIME
1904	TIME
St. Anthony Hall	ORG
Georgetown University	ORG
William Howard Taft	PER
Philippines	LOC
1905	TIME
Pennsylvania House of Representatives	ORG
1909	TIME
1911	TIME
62nd Congress	ORG
May 23, 1911	TIME
Joel Cook	PER
May 23 , 1911	TIME
March 3 , 1913	TIME
1912	TIME
Yellowtail Dam	LOC
Bighorn River	LOC
Montana	LOC
mid-1960s	TIME
Bighorn Lake	LOC
U.S. Bureau of Reclamation	ORG
Crow Nation	ORG
Native Americans	ORG
Crow Indian Reservation	LOC
Wyoming	LOC
1961	TIME
six years	TIME
Tango SA	ORG
Luxembourg	LOC
9	NUM
17	NUM
Vodafone	ORG
January 2018	TIME
280,000	NUM
3	NUM
Belgium	LOC
Proximus Group	ORG
2008	TIME
Telindus	ORG
ICT	MISC
Cloud	MISC
Proximus Luxembourg	MISC
October 2016	TIME
Dany Morin	PER
December 19, 1985	TIME
Canadian	LOC
House of Commons of Canada	ORG
Chicoutimi	LOC
Le Fjord	LOC
New Democratic Party	ORG
Randall Garrison	PER
Morin	PER
Liberal	ORG
Denis Lemieux	PER
Monsieur Fulgence	MISC
Saguenay – Lac - Saint - Jean	LOC
Jack D. Schwager	PER
January 26, 1992	TIME
HarperCollins	ORG
Market Wizards	MISC
Saddam Hussein	PER
Kuwait	LOC
42	NUM
ToothPick.com	ORG
NHS	ORG
Beta	MISC
November 2012	TIME
2013	TIME
Sandeep Senghera	PER
Jozef Wallis	PER
ToothPick	ORG
Henry Schein	PER
Passion Capital	ORG
Pradeep Menon	ORG
Paul Edwards	PER
Satish Jayakumar	PER
Michael Stephanblome	PER
WhatClinic	ORG
November 9, 2015	TIME
RANC	ORG
HMAS Creswell	ORG
Royal Australian Navy	ORG
RAN School of Survivability and Ship 's Safety	ORG
Kalkara Flight	ORG
Beecroft Weapons Range	ORG
Jervis Bay Village	LOC
Greenpatch	LOC
Jervis Bay	LOC
Jervis Bay Territory	LOC
Charles Huxtable	PER
Naval Waters for Jervis Bay	ORG
Navy	ORG
1915	TIME
Dwight Tillery	PER
Democratic Party	ORG
Cincinnati	LOC
West End	LOC
University of Cincinnati	ORG
the 1960s	TIME
United Black Association	ORG
University of Michigan Law School	ORG
1991	TIME
Cincinnati City Council	ORG
African American	ORG
The Center for Closing the Health Gap	ORG
Center for Closing the Health Gap	ORG
Greater Cincinnati	LOC
HIV	MISC
René-Lévesque	LOC
Côte - Nord	LOC
Quebec	LOC
National Assembly of Quebec	ORG
Manicouagan Regional County Municipality	LOC
La Haute - Côte - Nord Regional County Municipality	LOC
Baie-Comeau	LOC
Forestville	LOC
1948	TIME
Charlevoix-Saguenay	LOC
2003	TIME
René Lévesque	PER
Erich Klossowski	PER
19 December 1875	TIME
23 January 1949	TIME
Poland	LOC
Pierre Klossowski	PER
Balthus	PER
Ragnit	LOC
Rola	PER
Prussian	LOC
Honoré Daumier	PER
Munich	LOC
1914	TIME
Baladine Klossowska	PER
Rainer Maria Rilke	PER
Sanary - sur - Mer	LOC
Guy	PER
Amiens	LOC
d.1075	TIME
eleventh - century	TIME
Ponthieu	LOC
Boulogne	LOC
12th century	TIME
Enguerrand II	PER
Guy I	PER
Hugh II	PER
Enguerrand I	PER
Boulognnais	LOC
Arnold II	PER
Fulk	PER
Forest l'Abbaye	LOC
Robert	PER
László Zarándi	PER
10 June 1929	TIME
Hungarian	LOC
100 metres	NUM
Kiskunfélegyháza	LOC
1946/47	TIME
SZVSE	ORG
Hungary	LOC
1952 Summer Olympics	MISC
Helsinki	LOC
Finland	LOC
Géza Varasdi	PER
György Csányi	PER
Béla Goldoványi	PER
29 August 1954	TIME
Bern	LOC
European Championship of Athletics	MISC
1952	TIME
High Schoeo for Physical Education	ORG
László Szalma	PER
4	NUM
Olympic Games	MISC
1980	TIME
Dragan Ivanov	PER
Cabinet of Radoman Božović	ORG
December 23 , 1991	TIME
Dragutin Zelenović	PER
Serbia	LOC
Serbian	LOC
100 days	TIME
10,000%	NUM
Vojislav Šešelj	PER
February 10, 1993	TIME
Socialist Party of Serbia	ORG
Serbian Radical Party	ORG
December 20 , 1992	TIME
Božović	PER
Socialist	ORG
Radicals	ORG
Nikola Šainović	PER
Castroverde	LOC
Lugo province	LOC
Spain	LOC
Galicia	LOC
37	NUM
R Adams Cowley	PER
July 25 , 1917	TIME
October 27 , 1991	TIME
Father of Trauma Medicine	MISC
University of Maryland	ORG
1958	TIME
US Army	ORG
$ 100,000	NUM
Golden Hour	MISC
60 minutes	TIME
1969	TIME
Society of Thoracic Surgeons	ORG
EMS	MISC
MIEMSS	ORG
Executive Order	MISC
Maryland	LOC
Mandel	PER
1972	TIME
National Study Center for Trauma and EMS	ORG
Ronald Reagan	PER
Dwight D. Eisenhower	PER
S. Justin Selvaraj	PER
Telugu	LOC
Hindi	LOC
Vasanth	PER
Sabapathy	PER
Vaali	PER
Kushi	MISC
2000	TIME
New	PER
Anbe Aaruyire	MISC
Isai	MISC
Kalvanin Kadhali	MISC
Thirumagan	MISC
Vyabari	MISC
Antagonist	PER
Spyder	MISC
2017	TIME
Mersal	MISC
Fort Pitt Tunnel	LOC
Interstate 376	LOC
U.S. Route 22	LOC
US 30	LOC
US 19 Truck	MISC
Downtown Pittsburgh	LOC
the U.S.	LOC
Mount Washington	LOC
Fort Pitt Bridge	LOC
Southwestern Pennsylvania	LOC
Golden Triangle	LOC
The New York Times	MISC
KDKA-TV	ORG
the 1980s	TIME
Stephen Chbosky	PER
The Perks of Being a Wallflower	MISC
Liberty Tunnels	LOC
Squirrel Hill Tunnel	LOC
Wabash Tunnel	LOC
Mount Washington Transit Tunnel	LOC
Immigration Depot	LOC
Aapravasi Ghat	LOC
Port Louis	LOC
Indian Ocean	LOC
Mauritius	LOC
1923	TIME
half a million	NUM
British Empire	LOC
Indians	LOC
68 percent	NUM
the mid-20th century	TIME
Mauritian	LOC
World Heritage Site	MISC
Aapravasi Ghat Trust Fund	ORG
1860s	TIME
Love , Death & Mussolini	MISC
Steven Wilson	PER
nine	NUM
The Nostalgia Factory	ORG
Out	MISC
Yellow Hedgerow Dreamscape	MISC
It Will Rain for a Million Years	MISC
On the Sunday of Life ...	MISC
10	NUM
Love, Death & Mussolini	MISC
Alan Duffy	PER
JC Camillioni	PER
Hinduism	ORG
Los Angeles	LOC
the late 19th century	TIME
Hindu	LOC
Swami Vivekananda	PER
–1902	TIME
Ramakrishna Paramahamsa	PER
Swami Paramananda	PER
Vedanta	MISC
Boston	LOC
Hindus	ORG
Los Angeles Hindu Society	ORG
Pasadena Hindu Temple	LOC
City of Thuringowa	LOC
North Queensland	LOC
Townsville	LOC
Thuringowa Central	LOC
Thuringowa	LOC
Thuringia	LOC
John von Stieglitz	PER
1 January 1986	TIME
City of Townsville	LOC
Queensland Government	ORG
Thuringowa City Council	ORG
Townsville City Council	ORG
New Townsville City	LOC
Council	ORG
15 March 2008	TIME
Sāpai	ORG
Ghurghakhti Pashtun	ORG
Pech Valley	LOC
Kunar	LOC
Parwan Province	LOC
Kapisa Province	LOC
Kabul Province	LOC
Laghman Province	LOC
Nuristan Province	LOC
Kunar Province	LOC
Durand Line	LOC
1900	TIME
Khyber Pakhtunkhwa	LOC
Peshawar	LOC
Charsadda	LOC
Mardan	LOC
Nowshehra	LOC
Swabi	LOC
Rawalpindi	LOC
Tarnol	LOC
Lahore	LOC
Multan	LOC
Mohmand	LOC
Bajaur Agency	LOC
Federally Administered Tribal Areas	LOC
Zhob District	LOC
Balochistan	LOC
Pakistan	LOC
Pershing	ORG
1966	TIME
Beatrice	LOC
Nebraska	LOC
Midwestern	LOC
Parsons College	ORG
Fairfield	LOC
Iowa	LOC
1950s	TIME
Parsons Plan	MISC
Millard Roberts	PER
Vietnam War	MISC
Southeast Community College	ORG
Pierre Jean "Buster" Martin	PER
1 September 1906	TIME
12 April 2011	TIME
United Kingdom	LOC
Pimlico Plumbers	ORG
Liberal Democrat	ORG
Menzies Campbell	PER
97	NUM
Security Council	ORG
UN	ORG
fifteen	NUM
UN Charter	MISC
People's Republic of China	LOC
Republic of China	LOC
Soviet Union	LOC
Eric Reed Boucher	PER
June 17, 1958	TIME
San Francisco	LOC
Dead Kennedys	ORG
1979	TIME
Alternative Tentacles	ORG
East Bay Ray	PER
California Supreme Court	ORG
$ 200,000	NUM
Green Party	ORG
2000 United States Presidential Election	MISC
Ralph Nader	PER
Yippies	ORG
Marlo Chandler	PER
Marvel Comics	ORG
Peter David	PER
The Incredible Hulk	MISC
September 1988	TIME
Captain Marvel	MISC
1999–2004	TIME
Rick Jones	PER
Hulk	PER
Betty Ross	PER
Philip Marlowe	PER
Raymond Chandler	PER
Empire of Japan	LOC
French State	LOC
Indochinese	LOC
26 September 1940	TIME
Battle of South Guangxi	MISC
Sino-Japanese War	MISC
French Indochina	LOC
Kunming – Hai Phong Railway	LOC
Haiphong	LOC
Hanoi	LOC
Kunming	LOC
Yunnan	LOC
Tonkin	LOC
Patricia Stephens Due	PER
December 9 , 1939	TIME
February 7 , 2012	TIME
African	LOC
Florida	LOC
Priscilla	PER
CORE	ORG
49 days	TIME
Woolworth	LOC
Tallahassee	LOC
NAACP	ORG
Tananarive	PER
Freedom in the Family : a Mother - Daughter Memoir of the Fight for Civil Rights	MISC
Florida A&M ; University	ORG
John D. Due	PER
Askar Simitko	PER
1953–January 28 , 1995	TIME
Kurdish	LOC
Turkey	LOC
Istanbul	LOC
Urmia	LOC
West Azarbaijan	LOC
Tahirhan	PER
September 1985	TIME
Barzani	LOC
SAVAMA	ORG
Mohammad Reza Pahlavi	PER
People 's Mujahedin	ORG
Susurluk	LOC
Kutlu Savaş	PER
January 15, 1995	TIME
Lazım Esmaeili	PER
Polat Renaissance Hotel	LOC
Yeşilköy	LOC
03:45	TIME
Kerev Creek	LOC
Silivri	LOC
Second MIT Report	MISC
Mehmet Eymür	PER
Ou Reang Ov District	LOC
Tboung Khmum	LOC
Ou Reang Ov	LOC
30 kilometres	NUM
Kampong Cham Province	LOC
Prey Veng	LOC
42 kilometres	NUM
31 December 2013	TIME
National Highway 11	LOC
Neak Leung	LOC
National Highway 7	LOC
Thnal Totoung	LOC
Tboung Kmom District	LOC
adoption reunion registry	MISC
British Columbia	LOC
Newfoundland	LOC
Ontario	LOC
International Soundex Reunion Registry, Inc.	ORG
ISRR	ORG
April 2005	TIME
National Adoption Contact Preference Register	MISC
Ireland	LOC
Irish	LOC
Hide & Seek	MISC
South Korean	LOC
Tohoshinki	ORG
Tree	MISC
Something	MISC
Avex Trax	ORG
Bigeast Board	MISC
Team Batista 4	MISC
Oricon Singles Chart	MISC
Billboard Japan Hot 100	MISC
RIAJ	ORG
100,000	NUM
Huda al-Attas	PER
Southern Yemeni	LOC
Dawʿan	LOC
Hadhramaut	LOC
Al - Afif prize	MISC
1997	TIME
hājis rūḥ wa hājis jasad	MISC
Aden	LOC
1995	TIME
University of Aden	ORG
Yemeni Writers' Union	ORG
Ibtisam al-Mutawakkil	PER
Southern Movement	MISC
Arabic	LOC
Yemen	LOC
Perle dello Yemen	MISC
Old and New Dreams	ORG
Dewey Redman	PER
musette	MISC
Charlie Haden	PER
Don Cherry	PER
Ed Blackwell	PER
Ornette Coleman	PER
ECM	ORG
Playing	MISC
a year	TIME
Black Saint	ORG
A Tribute to Blackwell	MISC
Adventure Time	MISC
Cole Sanchez	PER
Rebecca Sugar	PER
Patrick McHale	PER
Adam Muto	PER
Kent Osborne	PER
Pendleton Ward	PER
Jeremy Shada	PER
John DiMaggio	PER
Olivia Olson	PER
Tom Kenny	PER
Marshall Lee	PER
Donald Glover	PER
Cartoon Network	ORG
February 18, 2013	TIME
Fionna and Cake	MISC
Madeleine Martin	PER
Roz Ryan	PER
Glover	PER
Neil Patrick Harris	PER
3.1 million	NUM
John Udell	PER
22 June 1795	TIME
30 June 1874	TIME
Baptist	ORG
Great Plains	LOC
1850	TIME
1859	TIME
Solano County	LOC
Sonoma County	LOC
Incidents of Travel to California Across the Great Plains	MISC
1856	TIME
Journal of John Udell , Kept During a Trip Across the Plains	MISC
Rose-Baley Party	ORG
Animositisomina	MISC
Ministry	MISC
Sanctuary Records	ORG
Sphinctour	MISC
Aoxomoxoa	MISC
Grateful Dead	MISC
Fuse 's Uranium	MISC
Jourgensen	PER
The Light Pours Out of Me	MISC
Magazine	ORG
Real Life	MISC
1978	TIME
1980s	TIME
Paul Barker	PER
Hypo Luxa / Hermes Pan	MISC
Houses of the Molé	MISC
April 2016	TIME
With Sympathy	MISC
Barker	PER
Leper	MISC
Hellmut G. Haasis	PER
7 January 1942	TIME
Georg Elser	PER
Adolf Hitler	PER
1939	TIME
Reinhard Heydrich	PER
Holocaust	MISC
Joseph Süß Oppenheimer	PER
1738	TIME
1940	TIME
Nazi	ORG
Jud Süß	MISC
Mühlacker	LOC
Swabia	LOC
Swabian	MISC
Thaddäus Troll Literature Prize	MISC
Schubart Literature Prize	MISC
Civis Media Prize	MISC
Maximato	ORG
Mexico	LOC
1928	TIME
1934	TIME
Plutarco Elías Calles	PER
six - year	TIME
Alvaro Obregón	PER
July 1928	TIME
Partido Nacional Revolucionario	ORG
1929	TIME
Emilio Portes Gil	PER
1 December 1928	TIME
4 February 1930	TIME
Pascual Ortiz Rubio	PER
September 1932	TIME
Abelardo L. Rodríguez	PER
Lázaro Cárdenas	PER
Mexican	LOC
Theology	MISC
Sinéad O'Connor	PER
Rubyworks	ORG
Koch Records	ORG
Dublin Sessions	MISC
London Sessions	MISC
I Do n't Know How to Love Him	MISC
Andrew Lloyd Webber	PER
Tim Rice	PER
Jesus Christ Superstar	MISC
Billboard 's Independent Albums	MISC
4,700	NUM
375,000	NUM
Shoghaken Folk Ensemble	ORG
Armenian	LOC
Yerevan	LOC
Armenia	LOC
Théâtre de la Ville	LOC
Estonia	LOC
United Arab Emirates	LOC
eighteen	NUM
2002 Folklife Festival	MISC
Yo Yo Ma	PER
Ararat	MISC
Shoghaken Ensemble : Music From Armenia	MISC
Hasmik Harutyunyan	PER
Aleksan Harutyunyan	PER
yellow - faced honeyeater	MISC
Meliphagidae	MISC
twenty	NUM
thirty minutes	TIME
Banksia	MISC
Grevillea	MISC
March	TIME
May	TIME
Queensland	LOC
July	TIME
August	TIME
New South Wales	LOC
Victoria	LOC
Honeyeaters	MISC
International Union for Conservation of Nature	ORG
Why Did n't They Ask Evans	MISC
Agatha Christie	PER
the United Kingdom	LOC
Collins Crime Club	ORG
September 1934	TIME
Dodd , Mead and Company	ORG
1935	TIME
The Boomerang Clue	MISC
seven shillings	NUM
sixpence	NUM
7/6	NUM
$ 2.00	NUM
Bobby Jones	PER
Frances Derwent	PER
Evans	PER
Poirot	PER
Robert Barnard	PER
Lively	MISC
Evelyn Waugh	PER
Vile Bodies	MISC
Livia Bitton-Jackson	PER
February 28, 1931	TIME
Samorin	LOC
Czechoslovakia	LOC
13 years old	NUM
Bubi	PER
Ghetto	LOC
Nagymagyar	LOC
Auschwitz	LOC
1945	TIME
New York University	ORG
Hebrew	ORG
I Have Lived a Thousand Years	MISC
Forgotten Freshness	MISC
Insane Clown Posse	ORG
Detroit	LOC
Forgotten Freshness Volumes 1 & 2	MISC
Ghetto Zone	MISC
Life At Risk	MISC
Ask You Somethin	MISC
Southwest Strangla	MISC
3 Ring	MISC
12	NUM
Riddle Box	MISC
Black River	LOC
Michigan	LOC
Lake Michigan	LOC
South Haven	LOC
South Pier Lighthouse	LOC
13	NUM
North Branch Black River	LOC
Middle Branch Black River	LOC
South Branch Black River	LOC
Black River Drain	LOC
Leverich Drain	LOC
North State Road Drain	LOC
Clyde Township	LOC
Ganges Township	LOC
Allegan County	LOC
Little Bear Lake Drain	LOC
Melvin Creek	LOC
Lee Township	LOC
Van Buren County	LOC
Lower Jeptha Lake Drain	LOC
Black River Extension Drain	LOC
Columbia Township	LOC
Breedsville	LOC
three miles	NUM
Van Buren	LOC
Allegan	LOC
Brain - Washing	MISC
Russian	MISC
Lavrentiy Beria	PER
Soviet	LOC
Kenneth Goff	PER
Scientology	ORG
L. Ron Hubbard	PER
Oliver Kenneth Goff	PER
L Ron Hubbard Jr.	PER
The Communist Manual of Psycho - Political Warfare	MISC
the Communist Manual of Instructions of Psychopolitical Warfare	MISC
Unearthed	MISC
Johnny Cash	PER
Rick Rubin	PER
Cash	PER
Rock	MISC
The Resurrection of Johnny Cash : Hurt , Redemption , and American Recordings	MISC
Cascais	LOC
Greater Lisbon	LOC
Portugal	LOC
Portuguese Riviera	LOC
206,479	NUM
97.40   km	NUM
the 1870s	TIME
Luís I	PER
Edward VIII	PER
Juan Carlos I	PER
Umberto II	PER
Iberian Peninsula	LOC
KeyBank Pavilion	LOC
Burgettstown	LOC
25 miles	NUM
Pittsburgh	LOC
23,000	NUM
7,100	NUM
16,000	NUM
Live Nation	ORG
Billy Joel	PER
June 17, 1990	TIME
Post - Gazette Pavilion	LOC
Pittsburgh Post - Gazette	ORG
February 2010	TIME
First Niagara Bank	ORG
2016	TIME
KeyCorp	ORG
Stage AE	LOC
North Shore	LOC
Heinz Field	LOC
Smilacaceae	MISC
Liliaceae	MISC
thirty years	TIME
55 millions years	TIME
Early Paleogene	TIME
Paleocene	TIME
Eocene	TIME
Liliales	MISC
We Lost the Road	MISC
Bee Gees	ORG
Barry Gibb	PER
Robin Gibb	PER
To Whom It May Concern	MISC
Trafalgar	MISC
January 28 , 1971	TIME
Barry	PER
2	NUM
Robin	PER
Pauline Bonaparte	PER
20 October 1780	TIME
9 June 1825	TIME
Guastalla	LOC
Sulmona	LOC
Rossano	LOC
Letizia Ramolino	PER
Carlo Buonaparte	PER
Corsica	LOC
Louis XVI of France	PER
Napoleon	PER
Charles Leclerc	PER
1802	TIME
Camillo Borghese	PER
Prince of Sulmona	PER
Dermide Leclerc	PER
Bonaparte	PER
Elba	LOC
Evelina De Lain	PER
Evelina Renatovna Pronskaya	PER
2 February 1977	TIME
Zhovti Vody	LOC
Dnipropetrovsk	LOC
Ukraine	LOC
5	NUM
14	NUM
M. Glinka Conservatoire	ORG
Broadway	ORG
Jeanne Lehman	PER
Potz	PER
Beauty and the Beast	MISC
Kissy Simmons	PER
Nahla	PER
Lion King	MISC
Azerbaijani Popular Front Party	ORG
Azerbaijan	LOC
Abulfaz Elchibey	PER
Ali Kerimli	PER
Mirmahmud Miralioglu	PER
7 January 2001	TIME
11.0 %	NUM
6	NUM
125	NUM
Gudrat Hasanguliyev	PER
0.4 %	NUM
15 October 2003	TIME
6 November 2005	TIME
Freedom	ORG
Donaldson Air Force Base	LOC
United States Air Force	ORG
Greenville	LOC
South Carolina	LOC
Greenville Army Air Base	LOC
1963	TIME
Donaldson Center Airport	LOC
United States Army Air Forces	ORG
Third Air Force	ORG
B-25 Mitchell	MISC
C-124 Globemaster II	MISC
The Airlift Capital of the World	MISC
Berlin airlift	MISC
Korean War	MISC
Tactical Air Command	ORG
Military Air Transport Service	ORG
The Logical Song	MISC
Supertramp	ORG
Breakfast in America	MISC
A&M	ORG
US Billboard chart	MISC
Paul McCartney	PER
Roger Hodgson	PER
Classics Live	MISC
Breakfast	MISC
America World Tour	MISC
Act of Reinstating Independence of Lithuania	MISC
Council of Lithuania	ORG
16 February 1918	TIME
Lithuanian	ORG
Vilnius	LOC
Act	MISC
Jonas Basanavičius	PER
Vilnius Conference	MISC
Act of 8 January	MISC
Germans	ORG
1918	TIME
Cabinet of Lithuania	ORG
Wars of Independence	MISC
laconic Act	MISC
Constitutions of Lithuania	MISC
29 March 2017	TIME
Behzad Mirkhani	PER
May 13, 1969	TIME
Tehran	LOC
Persian	LOC
Iran House of Music	ORG
Irish Music Rights Organisation	ORG
Registry of Guitar Tutors	ORG
The Last Leaf	MISC
Baby	MISC
USA	LOC
The Queen	LOC
Spanish	LOC
Chile	LOC
Santiago Province	LOC
Santiago Metropolitan Region	LOC
Larraín	PER
Ñuñoa	LOC
La Reina Alta	LOC
Metropolitan Region	LOC
—Aerodrómo Eulogio Sánchez Errázuriz	LOC
Tobalaba)—	LOC
Avenida Larraín	LOC
Tom Scholz	PER
More Than a Feeling	MISC
Peace of Mind	MISC
Foreplay/Long Time	MISC
Rock and Roll Band	MISC
Smokin	MISC
Do n't Look Back	MISC
A Man I'll Never Be	MISC
Amanda	MISC
75 million	NUM
31 million	NUM
17 million	NUM
seven million	NUM
40 years	TIME
VH1	ORG
The Father - Thing	MISC
1954	TIME
Philip K. Dick	PER
Dick	PER
Body Snatchers	MISC
Underwood - Miller	ORG
Second Variety	MISC
Citadel	ORG
Philip K. Dick 's Electric Dreams	MISC
Michael Dinner	PER
Greg Kinnear	PER
Hangzhou	LOC
Mandarin	MISC
Zhejiang Province	LOC
East China	LOC
Hangzhou Bay	LOC
Ningbo	LOC
Grand Canal	LOC
West Lake	LOC
UNESCO World Heritage Site	LOC
21.102 million	NUM
9,018,000	NUM
September 2015	TIME
2022 Asian Games	MISC
Asian Games	MISC
Beijing	LOC
Guangzhou	LOC
Alibaba	ORG
eleventh G-20 summit	MISC
Google Keep	MISC
Google	ORG
March 20, 2013	TIME
Android	MISC
iOS	MISC
Keep	MISC
Google Now	MISC
Hugh Raymond McCrae	PER
4 October 1876	TIME
17 February 1958	TIME
Melbourne	LOC
George Gordon McCrae	PER
Sydney	LOC
Camden	LOC
Adam Lindsay Gordon	PER
W. J. Lincoln	PER
The Life 's Romance of Adam Lindsay Gordon	MISC
The Ship of Heaven	MISC
Independent Theatre	LOC
1933	TIME
Alfred Hill	PER
Norman Lindsay	PER
Kenneth Slessor	PER
Christopher Brennan	PER
Shaw Neilson	PER
Pat Sullivan	PER
Felix the Cat in New York	MISC
the 1920s	TIME
John Gough	PER
1903	TIME
51	TIME
Song of the Rain	MISC
Colombine	MISC
Facit catalog	MISC
Scandinavia	LOC
1947	TIME
Denmark	LOC
Faroes	LOC
Iceland	LOC
Norway	LOC
Greenland	LOC
Åland	LOC
Danish West Indies	LOC
20	NUM
FACIT 2007 Special	MISC
FACIT Postal VII	MISC
FACIT Sverige 2005	MISC
FACIT Special Classic	MISC
2018	TIME
Facit Förlag AB	ORG
Västerås	LOC
Belgrade	LOC
seventeen	NUM
Six	NUM
Belgrade City Proper	LOC
mesna zajednica	LOC
Belgraders	LOC
Palilula	LOC
Hadžipopovac	LOC
Profesorska Kolonija	LOC
Čukarica	LOC
Banovo Brdo	LOC
Čukarička Padina	LOC
Englezovac	LOC
Savinac	LOC
Vračar	LOC
Jevremovac	LOC
Stari Grad	LOC
Selo Rakovica	LOC
Voždovac	LOC
Rakovica	LOC
Bežanija	LOC
Bežanijski Blokovi	LOC
North America	LOC
61%	NUM
43%	NUM
Canadian " Oil Patch "	MISC
25,000	NUM
100	NUM
Alberta	LOC
Clark Kent	PER
Lois Lane	PER
Jerry Siegel	PER
Joe Shuster	PER
DC Comics	MISC
Action Comics # 1	MISC
June 1938	TIME
John Byrne	PER
Man of Steel	MISC
the 1990s	TIME
Dec. 1996	TIME
Convergence : Superman # 2	MISC
July 2015	TIME
Jonathan Samuel Kent	PER
Princessa	PER
Mónica Capel Cruz	PER
18 May 1975	TIME
World On Ice	MISC
Gran Circo Mundial	MISC
Frank Peterson	PER
16	NUM
All I Want	MISC
Valerie Dore	PER
The Night	MISC
Good Times	MISC
Eric Burdon & the Animals	ORG
Winds of Change	MISC
Eric Burdon	PER
John Weider	PER
Götz George	PER
Danny McCulloch	PER
Barry Jenkins	PER
San Franciscan Nights	MISC
Ai n't that So	MISC
Stranger in the House	MISC
Burdon	PER
Die Katze	PER
Ozzy Osbourne	PER
Under Cover	MISC
The Official Live Bootleg # 2	MISC
Small Town Crime	MISC
Walk Away Renée	MISC
Michael Brown	PER
Bob Calilli	PER
Tony Sansone	PER
Left Banke	ORG
July 1966	TIME
Steve Martin Caro	PER
13 weeks	TIME
Mamas & the Papas	ORG
California Dreamin	MISC
November 1965	TIME
World United Productions, Inc.	ORG
Harry Lookofsky	PER
Rolling Stone	ORG
220	NUM
500 Greatest Songs of All Time	MISC
The Four Tops	ORG
Rick Price	ORG
J. R. R. Tolkien	PER
Amras	PER
Amrod	PER
Fëanor	PER
Nerdanel	PER
Mahtan	PER
Quenya	MISC
Pityafinwë	PER
Little Finwë	PER
Top - russet	PER
Tolkien	PER
Amros	PER
Sindarin	MISC
Maedhros	LOC
War of the Jewels	MISC
Kinslaying of Sirion	MISC
Kopelman Quartet	ORG
Mikhail Kopelman	PER
Boris Kuschnir	PER
Igor Sulyga	PER
Mikhail Milman	PER
Moscow Conservatory	ORG
twenty - five years	TIME
Musikverein	LOC
Vienna	LOC
Dom Muzyki	LOC
Moscow	LOC
Concertgebouw	LOC
Amsterdam	LOC
Wigmore Hall	LOC
Elisabeth Leonskaja	PER
Mischa Maisky	PER
Julian Rachlin	PER
Edinburgh International Festival	MISC
Valladolid Festival	MISC
Zurich Festival	MISC
Colmar Festival	MISC
Prague Spring Festival	MISC
Wimbledon Music Festival	MISC
Ravinia Festival	MISC
Rammstein	ORG
Herzeleid	MISC
Ramstein air show disaster	MISC
Paul Landers	PER
Richard Kruspe	PER
David Lynch	PER
Lost Highway	MISC
Live aus Berlin	MISC
Till Lindemann	PER
05	TIME
Liebe ist für alle da	MISC
Made in Germany	MISC
Bück Dich	MISC
Wikitorial	MISC
Los Angeles Times	ORG
June 17, 2005	TIME
War and Consequences	MISC
War in Iraq	MISC
Jimmy Wales	PER
Wikimedia Foundation	ORG
Wikipedia	MISC
Love Story	MISC
Yelawolf	PER
April 21, 2015	TIME
Shady Records	ORG
Slumerican	ORG
Nashville	LOC
Tennessee	LOC
Eminem	PER
Malay	PER
WLPWR	PER
Box Chevy V	MISC
Till It's Gone	MISC
Whiskey in a Bottle	MISC
American You	MISC
Best Friend	MISC
51,000	NUM
Bože pravde	MISC
Constitution of Serbia	MISC
Principality of Serbia	LOC
Kingdom of Serbs	LOC
Croats	LOC
Slovenes	LOC
Parliament of Serbia	ORG
August 17, 2004	TIME
November 8, 2006	TIME
May 11, 2009	TIME
1872	TIME
Davorin Jenko	PER
Jovan Đorđević	PER
Marko kazuje na kome je carstvo	MISC
Marko	PER
Anna "Ans" Dresden-Polak	PER
24 November 1906	TIME
23 July 1943	TIME
Dutch	LOC
1928 Summer Olympics	MISC
Stella Blits-Agsteribbe	PER
Lea Kloot-Nordheim	PER
Sobibor	LOC
Judikje Themans-Simons	PER
Gerrit Kleerekoper	PER
Sobibor extermination camp	LOC
Westerbork concentration camp	LOC
Sobibór	LOC
Eva	PER
Barend Dresden	PER
Jewish Sports Hall of Fame	MISC
Swiss Lady	MISC
Swiss	LOC
Eurovision Song Contest	MISC
1977	TIME
Pepe Lienhard Band	ORG
Swiss Single Chart	MISC
Israel	LOC
Ilanit	PER
Ahava Hi Shir Lishnayim	MISC
Forbes	ORG
71	NUM
Carole Vinci	PER
Vivre	MISC
Fu River	LOC
Jiangxi province	LOC
Fuzhou	LOC
Wuyi Mountains	LOC
Nanchang	LOC
Poyang Lake	LOC
Gan River	LOC
Yangtze	LOC
Juliet of the Spirits	MISC
B-52s	ORG
Funplex	MISC
September 9, 2008	TIME
Federico Fellini	PER
Cindy Wilson	PER
Kate Pierson	PER
Fred Schneider	PER
Keith Strickland	PER
Old Dominion Lady Monarchs	ORG
Old Dominion University	ORG
Norfolk	LOC
NCAA Division I	ORG
Conference USA	ORG
AIAW	ORG
Immaculata	ORG
Delta State	ORG
West Chester State	ORG
Wayland Baptist	ORG
Stephen F. Austin	PER
Nancy Lieberman	PER
Anne Donovan	PER
UCLA	ORG
NCAA	ORG
José Luis Murature	PER
27 January 1876	TIME
15 September 1929	TIME
Argentine	LOC
Argentina	LOC
Buenos Aires	LOC
José P. Murature	PER
Dolores Legarrete	PER
Colegio Nacional de Buenos Aires	ORG
University of Buenos Aires	ORG
1898	TIME
La Nación	ORG
Military School	ORG
Hamburg	LOC
Seven Lakes High School	ORG
Fort Bend County	LOC
Texas	LOC
Cinco Ranch	LOC
Katy	LOC
Seven Meadows	LOC
Grand Lakes	LOC
Houston	LOC
Katy Independent School District	LOC
Texas Education Agency	ORG
27,000	NUM
US News	ORG
The Houston Chronicle 's Chronicle Cup	MISC
McKay	MISC
Bronx	LOC
20 years	TIME
Anthony Hamilton	PER
DJ Spinna Toshi Reagon	PER
Big lovely	PER
Roy Hargrove	PER
Jacques Schwarz-Bart	PER
Katalyst	PER
Mos Def	PER
Talib Kweli	PER
Tricky	PER
Carl Hancock Rux	PER
Amp Fiddler	PER
Tell it Like it Is	MISC
EP	MISC
Stephanie McKay	MISC
Kelis	PER
Brooklyn Funk Essentials	ORG
Marella Explorer	MISC
Century	MISC
Marella Cruises	ORG
TUI	ORG
MV Galaxy	MISC
Celebrity Cruises	ORG
Mein Schiff	MISC
Meyer Werft shipyard	LOC
Papenburg	LOC
25May 1995	TIME
May 1996	TIME
twelve years	TIME
Galaxy	MISC
Celebrity Galaxy	MISC
May 2009	TIME
TUI AG	ORG
Royal Caribbean Cruises Ltd.	ORG
15 May 2009	TIME
Mein Schiff 1	MISC
November 2010	TIME
Pierre Marsan	PER
June 29, 1948	TIME
Montreal	LOC
Robert-Baldwin	LOC
Quebec Liberal Party	ORG
Université du Québec à Montréal	ORG
Université de Montréal	ORG
Hotel - Dieu	ORG
Saint-Jérôme Hospital	ORG
Montreal Heart Institute	ORG
Hôpital du Sacré-Coeur	ORG
Santa Cabrini Hospital	LOC
Epic Foundation	ORG
Hôpital du Sacré Coeur Foundation	ORG
Association of Canadian Teaching Hospitals	ORG
Pour un Quebec en Santé	MISC
Health and Social Services	ORG
Jean Charest	PER
Immigration and Cultural Communities	ORG
Anna Jordan Huff	PER
Space Ballerinas	ORG
Olympia	LOC
All Your Faded Things	MISC
Justin Trosper	PER
This Is an Exercise	MISC
Kill Rock Stars	ORG
Beth Ditto	PER
Mirah	PER
Ithaca	LOC
The Microphones	ORG
Cloud Eye Control	ORG
Day/Moon	ORG
Police Beat	MISC
This World Made Itself	MISC
Myth and Infrastructure	MISC
Dreaming of Lucid Living	MISC
Miwa Matreyek	PER
Maureen Selwood	PER
Stealing Cinderella	MISC
Wicks	PER
September 2007	TIME
Starting Now	MISC
George Teren	PER
Rivers Rutherford	PER
fifty - two	NUM
Billboard	ORG
Billboard Hot Country Songs	MISC
Grand Ole Opry	MISC
University of Tennessee	ORG
Phillip Fulmer	PER
Courtney	PER
Ballblazer	MISC
Lucasfilm Games	ORG
Atari 8-bit	MISC
Atari 5200	MISC
Apple II	MISC
ZX Spectrum	MISC
Amstrad CPC	MISC
Commodore 64	MISC
MSX	MISC
Atari 7800	MISC
Nintendo Famicom	MISC
Ballblaster	MISC
David Levine	PER
LucasArts	ORG
Rainbow Arts	ORG
Masterblazer	MISC
Amiga	MISC
Atari ST	MISC
MS-DOS	MISC
March 31, 1997	TIME
Ballblazer Champions	MISC
Sony PlayStation	MISC
Rockwell City Bridge	LOC
Rockwell City	LOC
270th Street	LOC
Calhoun County	LOC
Iowa State Highway Commission	ORG
Des Moines	LOC
James B. Marsh	PER
Iowa Bridge Company	ORG
$ 11,690	NUM
$ 4,107.65	NUM
U.S. Highway 20	LOC
Kim Yoon-seok	PER
January 21, 1968	TIME
The Chaser	MISC
South Korea	LOC
Running Turtle	MISC
The Yellow Sea	MISC
Punch	MISC
2011),The	TIME
Sea Fog	MISC
The Classified File	MISC
The Priests	MISC
Hans Achim Litten	PER
19 June 1903	TIME
5 February 1938	TIME
Nazis	ORG
1932	TIME
Weimar Republic	LOC
three hours	TIME
Reichstag	ORG
five years	TIME
Dachau	LOC
The Man Who Crossed Hitler	MISC
1931	TIME
Yeshiva Rabbi Chaim Berlin	ORG
Haredi	ORG
Brooklyn	LOC
Yeshiva Tiferes Bachurim	ORG
Meir Berlin	PER
Bar - Ilan	ORG
Chaim Berlin	PER
Jerusalem	LOC
two thousand	NUM
Joseph Isaac Clanton	PER
1847	TIME
June 1 , 1887	TIME
The Cowboys	ORG
Wyatt	PER
Virgil	PER
Morgan Earp	PER
Doc Holliday	PER
October 26, 1881	TIME
Corral	LOC
Tombstone	LOC
Arizona Territory	LOC
19-year	NUM
Billy	PER
Holliday	PER
30-day	TIME
Wells Spicer	PER
Six years	TIME
Caniapiscau River	LOC
Koksoak River	LOC
Nunavik	LOC
Cree	ORG
Lac Sevestre	LOC
Fermont	LOC
Canadian Shield	LOC
Rivière aux Mélèzes	LOC
Kanniq Confluence	LOC
1985	TIME
La Grande	LOC
45 %	NUM
La Grande River	LOC
James Bay	LOC
Caniapiscau Reservoir	LOC
Lake Caniapiscau	LOC
9,600	NUM
September 1984	TIME
Chute du Calcaire	LOC
1,5 %	NUM
1,5	NUM
George River	LOC
James Bay region	LOC
Trans-Taiga Road	LOC
Bastille Day military parade	MISC
14 July	TIME
1880	TIME
Champs-Élysées	LOC
l'Arc de Triomphe	LOC
Place de la Concorde	LOC
French Republic	LOC
Marseille	LOC
Toulon	LOC
Brest	LOC
Belfort	LOC
Four	NUM
Christian	ORG
andreia	MISC
Temperance	MISC
Sōphrosynē	MISC
Greek word	MISC
Plato	PER
Republic Book IV	MISC
426	TIME
435	TIME
Protagoras 330b	MISC
Cicero	PER
Ambrose	PER
Augustine	PER
Hippo	LOC
Thomas Aquinas	PER
Latin	MISC
Quadrivium	MISC
Super Mario World	MISC
Nintendo	ORG
Super Nintendo Entertainment System	MISC
Mario	MISC
Toadstool	PER
Dinosaur Land	LOC
Bowser	PER
Koopalings	PER
Super Mario games	MISC
Luigi	PER
Yoshi	PER
Koopa Troopas	MISC
Nintendo Entertainment Analysis & Development	ORG
Takashi Tezuka	PER
Shigeru Miyamoto	PER
Nintendo Entertainment System	MISC
20 million	NUM
Yoshi 's Island	MISC
October 1995	TIME
Super Mario All - Stars + Super Mario World	MISC
Game Boy Advance	MISC
Virtual Console	MISC
Wii	MISC
Wii U	MISC
New Nintendo 3DS	MISC
Super NES Classic Edition	MISC
Pass It On	MISC
The Coral	ORG
Magic and Medicine	MISC
CD	MISC
DVD	MISC
3-minute	TIME
You Like Me Too Much	MISC
Scrubs	MISC
My Turf War	MISC
Ken Loach	PER
Looking for Eric	MISC
Monroe Township Public Schools	LOC
Monroe Township	LOC
Gloucester County	LOC
New Jersey	LOC
5,921	NUM
437.8	NUM
FTE	MISC
13.52:1	NUM
New Jersey Department of Education	ORG
Doctor in the House	MISC
Ralph Thomas	PER
Betty Box	PER
Nicholas Phipps	PER
Richard Gordon	PER
Ronald Wilkinson	PER
Great Britain	LOC
Dirk Bogarde	PER
the 1950s	TIME
Kenneth More	PER
Donald Sinden	PER
Donald Houston	PER
James Robertson Justice	PER
Lancelot Spratt	PER
Svetlana Yakovlevna Jitomirskaya	PER
June 4, 1966	TIME
Kharkiv	LOC
Valentina Borok	PER
Yakov Zhitomirskii	PER
Moscow State University	ORG
Vladimir Arnold	PER
Yakov Sinai	PER
University of California , Irvine	ORG
Artur Avila	PER
Quaudiophiliac	MISC
QuAUDIOPHILIAc	MISC
Frank Zappa	PER
DVD - Audio	MISC
Barking Pumpkin Records	ORG
Over - Nite Sensation	MISC
1973	TIME
Apostrophe	MISC
DiscReet Records	MISC
Dweezil Zappa	PER
1970	TIME
Chunga Basement	MISC
Chunga 's Revenge	MISC
Royce Hall	MISC
Abnuceals Emuukha Electric Orchestra	ORG
Orchestral Favorites	MISC
Lumpy Gravy	MISC
Adolphe Deschamps	PER
17 June 1807	TIME
19 July 1875	TIME
Belgian	LOC
Victor - Auguste - Isidor Deschamps	PER
1830	TIME
Catholic	ORG
Pierre de Decker	PER
La Revue de Bruxelles	ORG
Catholics	ORG
Liberals	ORG
Belgian Chamber of Representatives	ORG
1836	TIME
1839	TIME
Treaty of London	MISC
Great Powers	ORG
Netherlands	LOC
1842	TIME
1843	TIME
1864	TIME
Haps Magazine	MISC
Busan	LOC
Korean	LOC
Korea	LOC
Bobby McGill	PER
K - pop	MISC
Psy	PER
TIME	ORG
The Washington Post	MISC
New York Post	ORG
Gangnam Style	MISC
Kim Tae-kyun	PER
Shane Youman	PER
National Human Rights Commission of Korea	ORG
François Asselineau	PER
14 September 1957	TIME
Rally for France	ORG
UMP	ORG
Union Populaire Républicaine	ORG
European Union	ORG
Eurozone	LOC
NATO	ORG
Arrêt sur	PER
Frexit	ORG
0.92 %	NUM
Anarchy Reigns	MISC
PlatinumGames	ORG
Sega	ORG
Atsushi Inaba	PER
Masaki Yamanaka	PER
MadWorld	MISC
July 5, 2012	TIME
May 25	TIME
June 18	TIME
Twitter	MISC
March 2013	TIME
October 19, 2012	TIME
January 11, 2013	TIME
Karelian Republic	LOC
Petrozavodsk	LOC
643,548	NUM
Russian SFSR	LOC
Resolution of the Presidium of the All - Russian Central Executive Committee	MISC
All - Russian Central Executive Committee	ORG
June 27, 1923	TIME
Council of People 's Commissars	ORG
July 25 , 1923	TIME
Karelian Labor Commune	ORG
1956	TIME
Karelo-Finnish Soviet Socialist Republic	LOC
Set Them Free	PER
February 11, 1990	TIME
Kentucky	LOC
October 30, 2018	TIME
Stop The Music	MISC
U.S. Champion 2-Yr - Old Colt	MISC
Hail To Reason	MISC
Tyrant	MISC
Valseuse	MISC
Ann	PER
Jerome Moss	PER
Fasig - Tipton Calder	ORG
$ 45,000	NUM
Brian Mayberry	PER
Sting	PER
Pasadena Stakes	MISC
Santa Anita Park	LOC
Debutante Breeders' Cup Stakes	MISC
Bay Meadows Racetrack	LOC
Breeders ' Cup Juvenile Fillies	MISC
Kentucky Derby	MISC
Giacomo	MISC
Holy Bull	MISC
Tiago	MISC
Pleasant Tap	MISC
Bartolomeo Altomonte	PER
Bartholomäus Hohenberg	PER
24 February 1694	TIME
Warsaw	LOC
11 November 1783	TIME
Sankt Florian	LOC
Austrian	LOC
Martino Altomonte	PER
Jan Sobieskis	PER
Linz	LOC
St. Florian	LOC
Priory and Admont Abbey	LOC
Daniel Gran	PER
Give ' Em the Boot	MISC
Hellcat Records	ORG
July 29, 1997	TIME
Punk - O - Rama	MISC
Unsound	MISC
Epitaph Records	ORG
Roots Radicals	MISC
... And Out Come the Wolves	MISC
Rancid	ORG
Tim Armstrong	PER
Universal Declaration of Human Rights	MISC
early 1947	TIME
late 1948	TIME
Drafting Committee	ORG
United Nations Commission on Human Rights	ORG
Commission on Human Rights	ORG
Economic and Social Council	ORG
General Assembly of the United Nations	ORG
Commission	ORG
Declaration	MISC
John Peters Humphrey	PER
United Nations Secretariat	ORG
Eleanor Roosevelt	PER
René Cassin	PER
Charles Malik	PER
Lebanon	LOC
P. C. Chang	PER
Taiwan	LOC
Hansa Mehta	PER
Jacques Maritain	PER
Pua Kele Kealoha	PER
November 14 , 1902	TIME
August 29 , 1989	TIME
Olympic	MISC
Warren Kealoha	PER
1920 Summer Olympics	MISC
17-year - old	NUM
4×200-meter	NUM
Perry McGillivray	PER
Norman Ross	PER
Duke Kahanamoku	PER
100-meter	NUM
Molokai	LOC
Oahu	LOC
Seattle Biomedical Research Institute	ORG
250	NUM
South Lake Union	LOC
Seattle	LOC
WA	LOC
HIV / AIDS	MISC
malaria	MISC
Emerging & Neglected Diseases	MISC
leishmaniasis	MISC
Chagas disease	MISC
toxoplasmosis	MISC
Bolita	MISC
the latter 19th	TIME
20th centuries	TIME
Hispanic	ORG
La Charada	MISC
Stephen Burpee Appleby	PER
December 10 , 1903	TIME
Florenceville	LOC
New Brunswick	LOC
Harriet Elizabeth Estey	PER
1869	TIME
Woodstock	LOC
Liberal Party	ORG
1873	TIME
Carleton	LOC
Charles Connell	PER
1874	TIME
1878	TIME
George Heber Connell	PER
Legislative Assembly of New Brunswick	ORG
Return to Castle Wolfenstein	MISC
Activision	ORG
November 19, 2001	TIME
Microsoft Windows	MISC
PlayStation 2	MISC
Xbox	MISC
Linux	MISC
Macintosh	MISC
Wolfenstein	MISC
Gray Matter Interactive	ORG
Nerve Software	ORG
i d Software	MISC
Wolfenstein 3D	MISC
Splash Damage	MISC
Game of the Year	MISC
August 18, 2009	TIME
Jones	PER
June 30 , 1880	TIME
March 30 , 1972	TIME
Milwaukee Brewers	ORG
St. Louis Browns	ORG
Detroit Tigers	ORG
Pittsburgh Rebels	ORG
Ty Cobb	PER
Sam Crawford	PER
Frank Chance	PER
Three Finger Brown	PER
Hugh Duffy	PER
Jesse Burkett	PER
1919	TIME
Black Sox	ORG
The Glory of Their Times	MISC
Lawrence Ritter	PER
.270	NUM
1,000	NUM
Empty Estate	MISC
Wild Nothing	ORG
May 14, 2013	TIME
Captured Tracks	ORG
Bella Union	ORG
Jack Tatum	PER
nine months	TIME
Nocturne	MISC
Ajudhia Nath Khosla	PER
11 December 1892	TIME
Central Waterways Irrigation and Navigation Commission of India	ORG
New Delhi	LOC
University of Roorkee	ORG
1959	TIME
Padma Bhushan	MISC
Padma Vibhushan	MISC
Rajya Sabha	ORG
Upper house of Indian Parliament	ORG
Planning Commission of India	ORG
Odisha	LOC
September 1962	TIME
August 1966	TIME
September 1966	TIME
January 1968	TIME
Indian National Science Academy	ORG
62	NUM
Reisa National Park	LOC
Nordreisa Municipality	LOC
Troms	LOC
28 November 1986	TIME
Sámi	MISC
Njállaávzi	LOC
Arctic	LOC
Norwegian	LOC
Reisa	LOC
Imo	LOC
Reisadalen	LOC
Mollisfossen	LOC
Kautokeino	LOC
Finnmark county	LOC
Käsivarsi Wilderness Area	LOC
Catholic Church	ORG
Gambia	LOC
Sierra Leone	LOC
Anglophone	ORG
West African	LOC
Freetown	LOC
Holy See	MISC
Banjul	LOC
Eastern Catholic	ORG
national Episcopal Conference	MISC
Apostolic Nunciature	ORG
Liberia	LOC
Monrovia	LOC
Hemnes	LOC
Nordland county	LOC
Helgeland	LOC
Korgen	LOC
Bjerka	LOC
Bleikvasslia	LOC
Hemnesberget	LOC
Sund	LOC
Ranfjorden	LOC
Nordland Line	LOC
E6 highway	LOC
Mo i Rana	LOC
Korgfjell Tunnel	LOC
Vefsn	LOC
422	NUM
4,524	NUM
0.3%	NUM
East River	LOC
New River	LOC
West Virginia	LOC
Kanawha	LOC
Ridge - and - Valley Appalachians	LOC
East River Mountain	LOC
Mercer County	LOC
Bluefield	LOC
Ada	LOC
Ingleside	LOC
Hardy	LOC
Oakvale	LOC
Kellysville	LOC
Willowton	LOC
Glen Lyn	LOC
Giles County	LOC
West Virginia Route 112	LOC
U.S. Route 460	LOC
Girls Trip	MISC
Regina Hall	PER
Queen Latifah	PER
Tiffany Haddish	PER
Jada Pinkett Smith	PER
Malcolm D. Lee	PER
Kenya Barris	PER
Tracy Oliver	PER
Erica Rivinoja	PER
New Orleans	LOC
Essence Music Festival	MISC
American Black Film Festival	MISC
Miami	LOC
June 14, 2017	TIME
Universal Pictures	ORG
July 21, 2017	TIME
Time	MISC
$140 million	NUM
$ 100 million	NUM
Traveling Wilburys Collection	MISC
Traveling Wilburys	ORG
11 June 2007	TIME
Rhino	ORG
Wilburys	MISC
Two	NUM
Jeff Lynne	PER
Harrison	PER
Dhani	PER
Britain	LOC
Seventh Plan	MISC
Ministry of Finance	ORG
MoF	ORG
Benazir Bhutto	PER
Economic Coordination Committee	ORG
Planning Commission	ORG
Zulfikar Ali Bhutto	PER
6.6%—	NUM
Nawaz Sharif	PER
Miss Little Havana	MISC
Cuban	LOC
Gloria Estefan	PER
Unwrapped	MISC
twenty - sixth	NUM
September 27, 2011	TIME
Crescent Moon Records	ORG
Verve Forecast	ORG
Universal Music Group	ORG
Pharrell Williams	PER
Estefan	PER
Emilio Estefan	PER
Target	ORG
13,697	NUM
21,522	NUM
Wepa	MISC
Billboard Hot Dance Club Songs	MISC
Capcom	ORG
Yukimura	PER
Sōichirō Hoshi	PER
Andrew Francis	PER
Devil Kings	MISC
Bosch	PER
Sengoku Basara	MISC
Date Masamune	PER
John Olav Egeland	PER
2 November 1951	TIME
Oslo	LOC
Erik Egeland	PER
John Oscar Egeland	PER
Orientering	ORG
Universitas	MISC
University of Oslo	ORG
Dagbladet	ORG
Narvesen Prize	MISC
Bærum	LOC
Budstikka	MISC
Frogner	LOC
Strathcona - Westmin Provincial Park	LOC
33   km²	NUM
Vancouver Island	LOC
Buttle Lake	LOC
Strathcona Provincial Park	LOC
Myra Falls Operations	ORG
NVI Mining Ltd.	ORG
Breakwater Resources Limited	ORG
creature features	MISC
The Lost World	MISC
1925	TIME
The Birds	MISC
Alfred Hitchcock	PER
Jaws	MISC
Steven Spielberg	PER
Grizzly	MISC
Piranha	MISC
Alligator	MISC
The Shallows	MISC
Johnny Mathis Sings the Music of Bacharach & Kaempfert	MISC
Johnny Mathis	PER
Columbia Records	ORG
Burt Bacharach	PER
Bert Kaempfert	PER
Strangers in the Night	MISC
Johnny Mathis Sings	MISC
12 months	TIME
Lady	MISC
Jack Jones	PER
The Lady Smiles	MISC
Matt Monro	PER
Billboard magazine	MISC
January 23 , 1971	TIME
seven weeks	TIME
Johnny Mathis Sings the Music of Bert Kaempfert	MISC
November 1969	TIME
Carl Linnaeus the Younger	PER
20 January 1741	TIME
1 November 1783	TIME
Linnaeus	PER
Carl Linnaeus	PER
University of Uppsala	ORG
Pehr Löfling	PER
Daniel Solander	PER
Johan Peter Falk	PER
1763	TIME
22	NUM
Practical Medicine	ORG
Supplementum Plantarum	MISC
1781	TIME
James Edward Smith	PER
Linnean Society of London	ORG
Karlheinz Martin	PER
May 6 , 1886	TIME
January 13 , 1948	TIME
Frankfurt am Main	LOC
Ernst Toller	PER
Transfiguration	MISC
September 30, 1919	TIME
300	NUM
Fritz Kortner	PER
1920	TIME
Georg Kaiser	PER
From Morn to Midnight	MISC
Ernst Deutsch	PER
Bertolt Brecht	PER
The Threepenny Opera	MISC
The Soldier Tanaka	MISC
subaltern	MISC
Antonio Gramsci	PER
subaltern studies	MISC
Subaltern Studies Group	ORG
Indian Subcontinent	LOC
Marxist	MISC
South Asian	LOC
Eurocentric	LOC
Africa	LOC
Asia	LOC
Lestock Peach Wilson DesBrisay	PER
March 28 , 1820	TIME
December 10 , 1872	TIME
Province of New Brunswick	LOC
Charlottetown	LOC
Prince Edward Island	LOC
Lucy Wright	PER
Theophilus DesBrisay	PER
1824	TIME
Chatham	LOC
Lestock P. W. DesBrisay	PER
Richibucto	LOC
October 14, 1841	TIME
Diana Gay Smith	PER
Rufus Smith	PER
Westmorland County	LOC
Kent County	LOC
1857	TIME
1865	TIME
Anglican Church Cemetery	LOC
Jakarta International Film Festival	MISC
JIFFEST	MISC
Indonesia	LOC
December	TIME
Jakarta	LOC
Indonesian	LOC
Wahyu Aditya	MISC
World Champion International Young Creative Entrepreneur of the Year	MISC
Tumpal Tampubolon	MISC
Asian Young Filmmakers Fellow Korea	MISC
Salman Aristo	MISC
Ayat-Ayat Cinta	MISC
Laskar Pelangi	MISC
Garuda di Dadaku	MISC
Yuli Andari Merdekaningtyas	PER
Suster Apung	MISC
Eagle Awards Metro TV	MISC
Albert Ogden " Scoop " Vorse Jr.	PER
August 9 , 1914	TIME
October 27 , 1979	TIME
United States Navy	ORG
Pacific	LOC
Battle of the Coral Sea	MISC
Guadalcanal Campaign	MISC
Butch O'Hare	PER
Jimmy Thach	PER
VF-80	ORG
Air Group 80	ORG
Peter Arnoldus Petersen	PER
21 March 1851	TIME
12 August 1916	TIME
Christiania	LOC
Johan Gottfried Schmidt	PER
Frederikke Døderlein	PER
1852	TIME
Peter J. K. Petersen	PER
1821	TIME
1896	TIME
Sigvart Petersen	PER
Peter Petersen & Co	ORG
Austro - Hungarian Empire	LOC
Nydalens Compagnie	ORG
1883	TIME
Hopetoun Blunder	MISC
Federation of the British colonies in Australia	ORG
1 January 1901	TIME
Parliament of Australia	ORG
Westminster system	MISC
House of Representatives	ORG
1 January	TIME
John Hope	PER
Hopetoun	LOC
Linlithgow	LOC
15 December 1900	TIME
Colonial Office	ORG
19 December	TIME
Canadian Confederation	ORG
William Lyne	PER
September 1899	TIME
George Reid	PER
New South Wales Legislative Assembly	ORG
Edmund Barton	PER
Alfred Deakin	PER
Gospel of John	MISC
Jesus	PER
Johannine	MISC
Book of Revelation	MISC
C. K. Barrett	PER
Raymond E. Brown	PER
Johannine Community	ORG
early Church	ORG
John	PER
Judaism	ORG
Christianity	ORG
Bicycle Thieves	MISC
The Bicycle Thief	MISC
Vittorio De Sica	PER
Cesare Zavattini	PER
Luigi Bartolini	PER
Lamberto Maggiorani	PER
Enzo Staiola	PER
Academy Honorary Award	MISC
four years	TIME
Sight & Sound	MISC
fifty years	TIME
British Film Institute	ORG
London Symphony Chorus	ORG
150	NUM
London Symphony Orchestra	ORG
Barbican Centre	LOC
Avery Fisher Hall	LOC
David J. Zuckerman	PER
August 28, 1962	TIME
Family Guy	MISC
Wilfred	MISC
Danville	LOC
University of California	ORG
The Fresh Prince of Bel - Air	MISC
Fox	ORG
King of the Hill	MISC
Seth MacFarlane	PER
American Dad !	MISC
FX	MISC
Stantec Tower	LOC
Ice District	LOC
Edmonton	LOC
JW	ORG
Marriott Edmonton Ice District & Residences	ORG
2019	TIME
Toronto	LOC
454	NUM
Stantec	ORG
Rogers Place	LOC
NHL	ORG
Edmonton Oilers	ORG
Barksdale Global Power Museum	LOC
Eighth Air Force Museum	LOC
Barksdale Air Force Base	LOC
Bossier City	LOC
Louisiana	LOC
the 2nd Bomb Wing	ORG
Air Force	ORG
Air Force Art	MISC
United States military aviation	ORG
Barksdale AFB	LOC
the 8th Air Force	ORG
Bossier Gate	LOC
9:30 AM	TIME
4:00 PM	TIME
Thanksgiving	MISC
New Year's Day	MISC
SNGN Romgaz SA	ORG
Romania	LOC
Eastern Europe	LOC
40 %	NUM
Government of Romania	ORG
70.01%	NUM
Fondul Proprietatea	ORG
14.99%	NUM
15%	NUM
Târgu Mureș	LOC
Mediaș	LOC
Ploieşti	LOC
Mediaş	LOC
Bratislava	LOC
Slovakia	LOC
Khirbet Khizeh	MISC
Israeli	LOC
S. Yizhar	PER
1949	TIME
Khirbet Hiz'ah	LOC
Arab	LOC
Israeli war of independence	MISC
Nakba	MISC
1964	TIME
Channel 1	MISC
Ram Loevy	PER
Rebecca Mann Pennell	PER
Rebecca Mann Dean	PER
1890	TIME
Horace Mann	PER
Antioch College	ORG
Yellow Springs	LOC
Yearning for Your Love	MISC
The Gap Band	ORG
Mercury Records	ORG
The Gap Band III	MISC
Hot Soul Singles	MISC
Gap Band	ORG
Oliver Scott	PER
Ronnie Wilson	PER
Charlie Wilson	PER
Brome - Missisquoi	LOC
Montérégie	LOC
Bromont	LOC
Cowansville	LOC
Frelighsburg	LOC
Sutton	LOC
Saint-Armand	LOC
Farnham	LOC
Brome	LOC
Missisquoi	LOC
Shefford	LOC
Austin	LOC
Bolton-Est	LOC
Bonsecours	LOC
Eastman	LOC
Lawrenceville	LOC
Potton	LOC
Sainte-Anne-de-la-Rochelle	LOC
Saint-Benoît-du-Lac	LOC
Saint-Étienne-de-Bolton	LOC
Stukely-Sud	LOC
Orford	LOC
Warden	LOC
Waterloo	LOC
Dexillus muelleri	MISC
Soleidae	MISC
Dexillus	MISC
Pacific Oceans	LOC
221 mm	NUM
Malay Archipelago	LOC
Tonga	LOC
Fiji	LOC
American Samoa	LOC
Brachirus macrolepis	MISC
Synaptura megalepidoura	MISC
Brachirus	MISC
Florida Suncoast Dome	LOC
St. Petersburg	LOC
Rays	ORG
December 2008	TIME
December 2017	TIME
St. Petersburg Bowl	MISC
Tampa Bay Lightning	ORG
Tampa	LOC
Tropicana Products	ORG
Bradenton	LOC
30-year	TIME
Gary Hall	PER
Jamaica	LOC
Juilliard	ORG
Simon Estes	PER
USA Network	ORG
Wendi Mercury	PER
One Life to Live	MISC
Daron Hagen	PER
Vera of Las Vegas	MISC
Off - Broadway	MISC
Opera for Dummies	MISC
The Boston Phoenix	MISC
GLAAD Media Award	MISC
America 's Got Talent	MISC
Cherry Grove	LOC
Small Business Administration	ORG
3 Cs	MISC
Recovery Act	MISC
Small Business Jobs Act	MISC
90 percent	NUM
23 percent	NUM
8(a )	MISC
HUBZone	MISC
900	NUM
Small Business Development Centers	ORG
110	NUM
Women's Business Centers	ORG
SCORE	ORG
350	NUM
1 million	NUM
Obama	PER
January 2012	TIME
Cabinet	ORG
Clinton	PER
Constitution of the Philippines	MISC
Filipino	MISC
Republic of the Philippines	LOC
Constitutional Commission	ORG
October 12, 1986	TIME
February 2, 1987	TIME
Three	NUM
Commonwealth Constitution	MISC
Constitution	MISC
Freedom Constitution	MISC
1899	TIME
Malolos Constitution	MISC
Kyle Hills	LOC
Ross Island	LOC
Antarctica	LOC
Mount Terror	LOC
Cape Crozier	LOC
Mount McIntosh	LOC
Advisory Committee on Antarctic Names	ORG
Philip R. Kyle	PER
New Mexico Institute of Mining and Technology	ORG
Socorro	LOC
28	NUM
New Zealand Antarctic Research Program	MISC
76	TIME
National Science Foundation	ORG
23	NUM
United States Antarctic Program	MISC
Mount Erebus	LOC
Mount Erebus Volcano Observatory	ORG
Anna-Lisa Björling	PER
March 15 , 1910	TIME
November 24 , 2006	TIME
Jussi Björling	PER
Royal Swedish Academy of Music	ORG
Royal Swedish Opera	LOC
late 1960s	TIME
1930s	TIME
96	NUM
George A. Romero 's Land of the Dead	MISC
George A. Romero	PER
Living Dead	MISC
Night of the Living Dead	MISC
Dawn of the Dead	MISC
Day of the Dead	MISC
Diary of the Dead	MISC
Survival of the Dead	MISC
$ 15–19   million	NUM
$ 46   million	NUM
the Throat	MISC
Nicholas II Sanudo	PER
1374	TIME
Gridia	LOC
Andros	LOC
Archipelago	LOC
Florence Sanudo	PER
Nicholas	PER
Guglielmazzo Sanudo	PER
Florence	LOC
Giovanni dalle Carceri	PER
1358	TIME
Vignoso	PER
Chios	LOC
Nerio I Acciajuoli	PER
Athens	LOC
Republic of Venice	LOC
Crete	LOC
1364	TIME
Nicholas Spezzabanda	PER
Maria	PER
Elisabetta Sanudo	PER
The Emergency Powers Act	MISC
Dáil Éireann	PER
2 September 1939	TIME
Emergency Powers Act 1939	MISC
Oireachtas	ORG
Emergency	MISC
2 September 1946	TIME
1 September 1976	TIME
1946	TIME
Related	ORG
New York City	LOC
Chicago	LOC
Las Vegas	LOC
Abu Dhabi	LOC
São Paulo	LOC
3,000	NUM
8,000	NUM
$ 4 billion	NUM
Taft Hartley	PER
Time Warner Center	LOC
CityPlace	LOC
West Palm Beach	LOC
Hudson Yards Redevelopment Project	MISC
Manhattan	LOC
Chelsea	LOC
Hell 's Kitchen	MISC
Emily Murphy	PER
14 March 186827 October 1933	TIME
The Famous Five	ORG
Henrietta Muir Edwards	PER
Nellie McClung	PER
Louise McKinney	PER
Irene Parlby	PER
1927	TIME
Persons Case	MISC
Senate	ORG
Supreme Court of Canada	ORG
Judicial Committee	ORG
British Privy Council	ORG
Sexual Sterilization Act of Alberta	MISC
Canadians	LOC
The Black Candle	MISC
Damgaard	PER
1 March 1981	TIME
Tillskärarakademin	LOC
Gothenburg	LOC
Philip Treacy	PER
four and a half years	TIME
Lars Wallin	PER
Madeleine	PER
Estelle	PER
Sugar rush	MISC
May 2013	TIME
The Art of Sweden	MISC
Elle	MISC
Sommar i P1	MISC
Isaac Charles Parker	PER
October 15 , 1838	TIME
November 17 , 1896	TIME
United States District Court for the Western District of Arkansas	ORG
21 years	TIME
American Old West	LOC
13,490	NUM
8,500	NUM
160	NUM
79	NUM
the 1890s	TIME
September 1896	TIME
Bright 's disease	MISC
Fort Smith	LOC
Johannes de Sacrobosco	PER
1195	TIME
1256	TIME
University of Paris	ORG
Tractatus de Sphaera	MISC
Julian calendar	MISC
three centuries	TIME
Gregorian calendar	MISC
1236	TIME
1244	TIME
Sumerian	ORG
Sud	PER
Lady of the Wind	MISC
Assyrian	ORG
Enlil	PER
Haia	PER
Ninshebargunnu	PER
Akkadian	ORG
Anu	PER
Sumerian Ki	PER
Nammu	PER
Dilmun	LOC
Nanna	PER
Ereshkigal	PER
Nergal	PER
Ninazu	PER
Enbilulu	PER
Ninurta	PER
Asag	PER
Sharur	PER
Adapa	LOC
Lady Wind	MISC
Lil - itu	PER
Hebrew Lilith	PER
Movimiento Revolucionario Túpac Katari de Liberación	ORG
Bolivia	LOC
Jenaro Flores Santos	PER
Tupaj Katari Revolutionary Movement	ORG
2.11 per cent	NUM
Cárdenas	PER
Walter Reynaga Vásquez	PER
National Congress	ORG
FULKA	ORG
1.6 per cent	NUM
Revolutionary Nationalist Movement	ORG
Revolutionary Left Movement	ORG
The Medallion	MISC
Hong Kong	LOC
Gordon Chan	PER
Jackie Chan	PER
Lee Evans	PER
Claire Forlani	PER
Julian Sands	PER
Rush Hour	MISC
Shanghai Noon	MISC
Shanghai Knights	MISC
TriStar Pictures	ORG
Eddie	PER
Interpol	ORG
Snakehead	PER
$ 34,268,701	NUM
$ 41   million	NUM
Jean	PER
1505	TIME
Lamballe	LOC
1564	TIME
René de Brosse	PER
Jeanne de Commines	PER
Philippe de Commines	PER
Battle of Pavia	MISC
Penthièvre	LOC
1533	TIME
Anne de Pisseleu d'Heilly	PER
Francis I	PER
Étampes	LOC
Diane de Poitiers	PER
Brittany	LOC
1543	TIME
Henry II	PER
Weymouth Township School District	LOC
Weymouth Township	LOC
Atlantic County	LOC
2014 - 15 school year	TIME
284	NUM
17.7	NUM
16.0:1	NUM
District Factor Group	ORG
Buena Regional High School	ORG
Buena Regional School District	LOC
Buena	LOC
Buena Vista Township	LOC
Estell Manor	LOC
153	NUM
25.0	NUM
6.1:1	NUM
Rocket Post	MISC
Stephen Whittaker	PER
Ulrich Thomsen	PER
Shauna Macdonald	PER
Kevin McKidd	PER
Patrick Malahide	PER
Scottish	LOC
Gerhard Zucker	PER
Scotland	LOC
Scarp	LOC
Taransay	LOC
Nigel Clarke	PER
Michael Csanyi - Wills	PER
Royal Philharmonic Orchestra	ORG
Hypsipyla	MISC
Moore	PER
1886	TIME
Madagascar	LOC
30   mm	NUM
Meliaceae	MISC
Toona	MISC
Chukrasia	MISC
Swietenia	MISC
Khaya	MISC
Xylocarpus	MISC
Haneke	PER
23 March 1942	TIME
Funny Games	MISC
Caché	MISC
The White Ribbon	MISC
Amour	MISC
Film Academy Vienna	ORG
Cannes Film Festival	MISC
Palme d'Or	MISC
Golden Globe Awards	MISC
Golden Globe Award for Best Foreign Language Film	MISC
Academy Award	MISC
Best Picture	MISC
Best Director	MISC
Best Original Screenplay	MISC
Best Actress in a Leading Role	MISC
Emmanuelle Riva	PER
Best Foreign Language Film	MISC
Asturias Award	MISC
Trágala	MISC
Rafael del Riego	PER
Cabezas de San Juan	LOC
Trienio Liberal	TIME
1820	TIME
Ferdinand VII	PER
Constitution of Cadiz	MISC
Holy Alliance	ORG
Hundred Thousand Sons	ORG
Saint Louis	LOC
Angoulême	PER
Ominous Decade	TIME
Ça Ira	MISC
Second Republic	LOC
Spanish Civil War	MISC
La Pitita	MISC
Senieji Trakai Castle	LOC
Trakai	LOC
Lithuania	LOC
Gediminas	PER
Kernavė	LOC
1321	TIME
Kęstutis	PER
Birutė	PER
Vytautas	PER
1350	TIME
Teutonic Order	ORG
1391	TIME
Benedictian	ORG
1405	TIME
the 15th century	TIME
15th century	TIME
KYB	ORG
85%	NUM
34	NUM
21	NUM
Addison	LOC
IL	LOC
North American	LOC
Gęsicka	PER
13 December 1951	TIME
10 April 2010	TIME
Polish	LOC
Regional Development	ORG
Marcinkiewicz	PER
Jarosław Kaczyński	PER
Law and Justice parliamentary caucus	ORG
Warsaw University's Institute of Sociology	ORG
Polish Sociological Society and the Association Internationale des Sociologues de Langue Francaise	ORG
Tupolev	MISC
Tu-154	MISC
36th Special Aviation Regiment	ORG
Lech Kaczyński	PER
Smolensk	LOC
Pechersk	LOC
25 April	TIME
Smolensk Cemetery Headquarters Military Cemetery	LOC
Commander 's Cross of the Order of Polonia Restituta	MISC
Poison Arrow	MISC
ABC	ORG
The Lexicon of Love	MISC
5 February 1982	TIME
7 "	NUM
12 "	NUM
Jazz Remix	MISC
Theme from Mantrap	MISC
The Look of Love	MISC
Mantrap ( The Lounge Sequence )	MISC
Tears Are Not Enough	MISC
Send in Stewie , Please	MISC
March 18, 2018	TIME
25 minutes	TIME
Gary Janetti	PER
Joe Vaux	PER
Stewie Griffin	PER
Ian McKellen	PER
Griffin	PER
Brian	PER
God of War	MISC
Chris Elder	PER
New Zealand	LOC
Russian Federation	LOC
Wellington	LOC
Asian	LOC
Asia-Pacific region	LOC
Ministry of Foreign Affairs and Trade	ORG
Michael Green	PER
1792	TIME
Robert Ayson	PER
Centre for Strategic Studies Discussion Paper , China 's Rise and New Zealand 's Interests : A Policy Primer for 2030	MISC
2030	TIME
Bare Island	LOC
City of Randwick	LOC
Botany Bay	LOC
New South Wales State Heritage Register	MISC
2 April 1999	TIME
nineteenth century	TIME
Peter Scratchley	PER
Gustave Morell	PER
James Barnet	PER
1881	TIME
1889	TIME
John McLeod	PER
NSW Department of Public Works	ORG
La Perouse	LOC
John Thornton Kirkland	PER
August 17 , 1770	TIME
April 26 , 1840	TIME
1828	TIME
Hasty Pudding	ORG
Kirkland House	LOC
Oliver Wendell Holmes	PER
Ralph Waldo Emerson	PER
George Ticknor	PER
New South Church	ORG
1794	TIME
American Academy of Arts and Sciences	ORG
American Antiquarian Society	ORG
Lament	MISC
Einstürzende Neubauten	ORG
7 November 2014	TIME
Diksmuide	LOC
World War I.	MISC
The Willy - Nicky Telegrams	MISC
Alexander Hacke	PER
Tsar Nicholas II	PER
Blixa Bargeld	PER
Kaiser Wilhelm	PER
James Reese Europe	PER
369th Infantry Regiment	ORG
Harlem Hellfighters	ORG
Field Marshals' Hall of the Winter Palace	LOC
Imperial Russia	LOC
Generalissimo	LOC
Joseph Stalin	PER
Winter Palace	LOC
Tsar Nicholas I	PER
1833	TIME
Auguste de Montferrand	PER
17 December 1837	TIME
thirty hours	TIME
Vasily Stasov	PER
State Hermitage Museum	LOC
The Best of the Art of Noise	MISC
The Art of Noise	ORG
China Records	ORG
November 1988	TIME
LP	MISC
7	NUM
Kiss	MISC
Yebo	MISC
Instruments of Darkness	MISC
Robinson Crusoe	MISC
ZTT Records	ORG
Beatbox	MISC
Moments in Love	MISC
Close	MISC
Holland	LOC
Péter Olajos	PER
18 April 1968	TIME
Budapest	LOC
European Parliament	ORG
MEP	ORG
Hungarian Democratic Forum	ORG
European People's Party	ORG
European Parliament 's Committee on the Environment , Public Health and Food Safety	ORG
Orban Government	ORG
Green Economy Development and Climate Policy	MISC
Cancun	LOC
UNFCCC COP-16	MISC
Hungarian Climate Team	ORG
Hungarian EU Presidency	ORG
Committee on the Internal Market and Consumer Protection	ORG
EU - Uzbekistan Parliamentary Cooperation Committees	ORG
Kazakhstan	LOC
Kyrgyzstan	LOC
Tajikistan	LOC
Turkmenistan	LOC
Mongolia	LOC
EU - Romania Joint Parliamentary Committee	ORG
Government	ORG
Climate Policy	MISC
Clean Energy and Energy Efficiency	MISC
Building Retrofitting Programs	MISC
Raymond Clinton Cole	PER
August 21 , 1870	TIME
February 8 , 1957	TIME
Ralph Dayton Cole	PER
Biglick Township	LOC
Findlay	LOC
Findlay College	ORG
nine years	TIME
Ohio Northern University	ORG
1901	TIME
Ohio National Guard	ORG
Sixty - eighth Congresses	ORG
March 4 , 1919	TIME
March 3 , 1925	TIME
Committee on Elections	ORG
1924	TIME
Sixty - ninth Congress	ORG
February 8, 1957	TIME
Bright Cemetery	LOC
Breadfruit	MISC
Moraceae	MISC
South Pacific	LOC
Oceania	LOC
Polynesian	LOC
Caribbean	LOC
18th century	TIME
90	NUM
South	LOC
Southeast Asia	LOC
Pacific Ocean	LOC
Central America	LOC
New Guinea	LOC
Indo - Malayan Archipelago	LOC
Micronesia	LOC
South America	LOC
Conrad Indianapolis	LOC
Indianapolis	LOC
Indiana	LOC
243	NUM
Conrad Hotels	ORG
Hilton Hotels & Resorts	ORG
Conde Nast Traveler	ORG
Expedia Insiders’	MISC
Conrad	LOC
On the Knocking at the Gate in Macbeth	MISC
Shakespearean	MISC
Thomas De Quincey	PER
October 1823	TIME
The London Magazine	MISC
Macbeth	PER
The Tragedy of Macbeth	MISC
Duncan	PER
Lady Macbeth	PER
Macduff	PER
Lennox	PER
Porter	PER
Shakespeare	PER
Horace Ainsworth Eaton	PER
Coleridge	PER
Hazlitt	PER
On Murder Considered as one of the Fine Arts	MISC
Christian Kramer	PER
Master of the King 's Musick	MISC
1829	TIME
George IV	PER
William IV	PER
Hannover	LOC
Romantic	MISC
Peter Winter	PER
Dwight 's Journal of Music	MISC
John Dwight	PER
Dictionary of Musical Information	MISC
1876	TIME
Bismarck	LOC
North Dakota	LOC
Burleigh County	LOC
Fargo	LOC
72,865	NUM
132,142	NUM
European	LOC
Americans	LOC
Missouri River	LOC
Dakota Territory	LOC
Union	ORG
Mandan	LOC
Native American	ORG
Bismarck - Mandan Metropolitan Statistical Area	LOC
North Dakota State Capitol	LOC
4,000	NUM
South Dakota	LOC
Pnau	MISC
PNAU	ORG
Nick Littlemore	PER
Peter Mayes	PER
Sam	PER
Sambanova	MISC
Elton John	PER
Soft Universe	MISC
Good Morning to the Night	MISC
Empire of the Sun	ORG
Chameleon	MISC
Changa	MISC
Mazinaw Rock	LOC
Addington Highlands	LOC
Kaladar	LOC
Mazinaw Lake	LOC
Bon Echo Provincial Park	LOC
Great Lakes	LOC
Bon Echo	LOC
260	NUM
Algonkian	MISC
Walt Whitman	PER
Flora MacDonald Denison	PER
the 1910s	TIME
Heatherly	PER
Disney	ORG
Club Penguin	ORG
Lane Merrifield	PER
Coins For Change	MISC
September 7, 2016	TIME
NBCUniversal	ORG
Minions	MISC
Despicable Me	MISC
NBC	ORG
Alfred	PER
Bristol	LOC
Hartford County	LOC
Connecticut	LOC
Hartford	LOC
120 miles	NUM
100 miles	NUM
60,477	NUM
ESPN	ORG
Lake Compounce	LOC
1846	TIME
the 19th century	TIME
American Clock & Watch Museum	LOC
American Silver Company	ORG
1851	TIME
Mum City	LOC
Bristol Mum Festival	MISC
Money	MISC
Best Places to Live	MISC
Hartford Magazine	MISC
Greater Hartford	LOC
Best Bang for the Buck	MISC
James Drewry Stewart	PER
March 29	TIME
McMaster University	ORG
Stanford University	ORG
University of Toronto	ORG
University of London	ORG
Calculus : Early Transcendentals	MISC
Hamilton Philharmonic Orchestra	ORG
Machine + Soul	MISC
Gary Numan	PER
Metal Rhythm	MISC
Outland	MISC
IRS Records	ORG
IRS	ORG
Sacrifice	MISC
Climate change in Germany	MISC
Angela Merkel	PER
CDU	ORG
1 %	NUM
COP23	MISC
George Redburn Young	PER
November 6 , 1946	TIME
October 22 , 2017	TIME
Easybeats	ORG
Flash and the Pan	ORG
one - half	NUM
Vanda & Young	ORG
Vanda	PER
Friday on My Mind	MISC
Love Is in the Air	MISC
John Paul Young	PER
AC/DC	ORG
Malcolm	PER
Angus Young	PER
ARIA Hall of Fame	MISC
Memorial City	LOC
Memorial	LOC
Katy Freeway	LOC
Beltway 8	LOC
Bunker Hill Road	LOC
Memorial City Mall	LOC
Memorial Hermann Memorial City Medical Center	LOC
CityCentre	LOC
Town & Country Village	LOC
MetroNational	ORG
47,000	NUM
4,400	NUM
Texas Legislature	ORG
Gottlob Honold	PER
26 August 1876	TIME
17 March 1923	TIME
Robert Bosch	PER
7 January 1902	TIME
Langenau	LOC
10 miles	NUM
Ulm	LOC
1891	TIME
Stuttgart	LOC
Stuttgart technical university	ORG
Daimler	ORG
Ozu	PER
Kōgo Noda	PER
103 days	TIME
1937	TIME
Make Way for Tomorrow	MISC
Leo McCarey	PER
1953	TIME
Sutherland Trophy	MISC
Tokyo Story	MISC
Michael Waters	PER
Gus Van Sant	PER
My Own Private Idaho	MISC
River Phoenix	PER
Scott Favor	PER
Keanu Reeves	PER
New Queer Cinema	MISC
Eric Alan Edwards	PER
Spilornis cheela	MISC
East Asia	LOC
S. holospila	MISC
S. elgini	MISC
S. klossi	MISC
Crested serpent eagle	MISC
Circaetus snake - eagles	MISC
subfamily Circaetinae	MISC
Kina Konova	PER
Sevlievo	LOC
September 1872-	TIME
Sofia	LOC
2 May 1952	TIME
Kina Moutafova	PER
Bulgarian	LOC
Bulgaria	LOC
Society of Friends	ORG
Women's Branch	ORG
Nadejda	ORG
1897	TIME
Bulgarian Women's Union	ORG
Vela Blagoeva	PER
Ekaterina Karavelova	PER
Anna Karima	PER
Julia Malinova	PER
27	NUM
Zhenski glas	MISC
Do n't Let It End	MISC
Kilroy Was Here	MISC
Styx	ORG
Dennis DeYoung	PER
RPM Top Singles	MISC
July 2 , 1983	TIME
classicrockrevisited.com	ORG
Roboto	PER
Show Me The Way	MISC
Babe	MISC
Best of Times	MISC
Lee Ahyoomi	PER
August 25, 1984	TIME
Sugar	ORG
Unrequited	MISC
The X - Files	MISC
Howard Gordon	PER
Chris Carter	PER
Michael Lange	PER
February 23, 1997	TIME
Fox network	ORG
Monster - of - the - Week	MISC
10.9	NUM
16.56 million	NUM
FBI	ORG
Fox Mulder	PER
David Duchovny	PER
Dana Scully	PER
Gillian Anderson	PER
X-Files	MISC
U.S. Army	ORG
Vietnam	LOC
60 Minutes	MISC
CIA	ORG
Vietnam Veterans Memorial	LOC
Bal - musette	MISC
North Africa	LOC
Algerian	LOC
Raï	MISC
Paris Opera	ORG
Orchestre de Paris	ORG
Paris Conservatory	ORG
Cité de la Musique	LOC
La Villette	LOC
Paris Symphony Hall	LOC
Conservatory	LOC
Le Zenith	LOC
Chih-Kung Jen	PER
August 15	TIME
October 2 , 1906	TIME
November 19 , 1995	TIME
20th century	TIME
Boxer Rebellion	MISC
19th century	TIME
Tsinghua University	ORG
MIT	ORG
University of Pennsylvania	ORG
Academic Long March	MISC
National Southwestern Associated University	ORG
Physics Department	ORG
Applied Physics Laboratory	ORG
Johns Hopkins University	ORG
Richard Nixon	PER
Zhou Enlai	PER
Barentsøya	LOC
Svalbard	LOC
Edgeøya	LOC
Spitsbergen	LOC
Willem Barents	PER
Søraust-Svalbard Nature Reserve	LOC
43 per cent	NUM
Kükenthaløya	LOC
Freemansundet	LOC
Barents Sea	LOC
Dørstubukta	LOC
Simon Davies	PER
Privacy International	ORG
July 2008	TIME
Stranton landmark Viacom	ORG
Viacom	ORG
Google & YouTube	ORG
YouTube	ORG
80/20 Thinking Limited	ORG
June 2015	TIME
Queenscliff	LOC
Warrnambool line	LOC
South Geelong	LOC
21 May 1879	TIME
Victorian Heritage Register	MISC
Swan Island	LOC
3 foot	NUM
Victorian Railways	ORG
6 November 1976	TIME
Bellarine Peninsula Railway	ORG
May 1979	TIME
Lakers Siding	LOC
Drysdale	LOC
Warnambool	LOC
Bellarine Rail Trail	LOC
Dow v Black	MISC
Legislatures	ORG
91	NUM
92	TIME
Constitution Act	MISC
Judicial Committee of the Privy Council	ORG
Supreme Court of New Brunswick	ORG
St. Stephen	LOC
8-mile	NUM
Debec	LOC
Houlton	LOC
Maine	LOC
92(2 )	NUM
91(29 )	NUM
92(10 )	NUM
Régine Hantelle	PER
1 March 1965	TIME
Alice	PER
Alice et Anaïs	ORG
A deux	MISC
L'étudiante	MISC
Le temps est long	MISC
L'amour avec toi	MISC
J't'en veux	MISC
Rêves des lunes	MISC
Didier Barbelivien	PER
Anaïs et Didier Barbelivien	ORG
Vendée ' 93	MISC
2 million	NUM
Les mariés de Vendée	MISC
Quitter l'autoroute	MISC
Jefferson Joseph DeBlanc	PER
February 15 , 1921	TIME
November 22 , 2007	TIME
Cajun	LOC
Marine Corps	ORG
Guadalcanal	LOC
Okinawa	LOC
January 31, 1943	TIME
Marine Corps Reserve	ORG
Committee on International Trade	ORG
7 July 2014	TIME
Bernd Lange	PER
EU	ORG
World Trade Organisation	ORG
Treaty of Lisbon	MISC
Common Commercial Policy	MISC
Grandfathering	MISC
Financial Responsibility	MISC
Enforcement’	MISC
Dual Use	MISC
Omnibus I and II	MISC
Generalised System of Preferences	MISC
Market Access Regulation	MISC
Trade Defence Instruments	MISC
Peru	LOC
Colombia	LOC
Anti - Counterfeiting Trade	MISC
Singapore	LOC
ACP	LOC
Jacques Lanxade	PER
8 September 1934	TIME
François Mitterrand	PER
French Armed Forces	ORG
Rwandan Genocide	MISC
Tunisia	LOC
Académie de Marine	ORG
Mediterranean Foundation for Strategic Research	ORG
Politique américaine	MISC
Niagara Stars	ORG
Canadian Baseball League	ORG
Welland	LOC
Dominican Republic	LOC
Pete LaCock	PER
Peter Marshall	PER
Dave MacLean	PER
Sony Discman	MISC
Hillary Clinton	PER
Arkansas	LOC
81	TIME
Democratic	ORG
2016 Democratic National Convention	MISC
Donald Trump	PER
2.8 million	NUM
38	NUM
65	NUM
112,735	NUM
Vital Signs	MISC
Rush	ORG
Moving Pictures	MISC
The Police	ORG
Signals	MISC
Grace Under Pressure	MISC
Power Windows	MISC
New World Man	MISC
Mercury # 76179	MISC
Time Machine Tour	MISC
Grace Under Pressure Tour	MISC
Alexander Alexandrovich Novikov	PER
December 3, 1976	TIME
Soviet Air Force	ORG
Hero of the Soviet Union	MISC
Politburo	ORG
NKVD	ORG
Zhukov	PER
The Franklin – Nashville Campaign	MISC
Hood 's Tennessee Campaign	MISC
Western Theater	LOC
September 18	TIME
December 27 , 1864	TIME
Alabama	LOC
northwestern Georgia	LOC
Confederate Army	ORG
John Bell Hood	PER
Atlanta	LOC
William T. Sherman	PER
Hood	PER
March to the Sea	MISC
Union forces	ORG
George H. Thomas	PER
Union force	ORG
John Schofield	PER
Thomas	PER
Battle of Spring Hill	MISC
November 29	TIME
Battle of Franklin	MISC
December 15–16	TIME
Battle of Nashville	MISC
Tupelo	LOC
Mississippi	LOC
Army of Tennessee	ORG
Planet of the Drums	ORG
AK1200	PER
Orlando	LOC
Darragh Guilfoyle	PER
Damian Higgins	PER
James Fiorella	PER
Tenth Anniversary Tour	MISC
U Street Music Hall	LOC
Washington, DC	LOC
Antonie Philips van Leeuwenhoek	PER
FRS	ORG
24 October 1632	TIME
26 August 1723	TIME
Delft	LOC
Dutch Republic	LOC
1654	TIME
1670s	TIME
1590s	TIME
1720s	TIME
Royal Society	ORG
Slow Life	MISC
Welsh	LOC
Super Furry Animals	ORG
Phantom Phorce	MISC
Phantom Power	MISC
Ciaran	PER
Motherfokker	MISC
Goldie Lookin Chain	ORG
Dylan Jones	PER
Paps O'Maoileoain	PER
9 Songs	MISC
Brixton Academy	ORG
François-Isidore Gagelin	PER
François - Isidore Gagelin	PER
10 May 1799	TIME
17 October 1833	TIME
Paris Foreign Missions Society	ORG
Montperreux	LOC
Doubs	LOC
1826	TIME
Minh Mạng	PER
Huế	LOC
Đồng Nai	LOC
Cochinchina	LOC
6 January 1833	TIME
August 1833	TIME
John Paul II	PER
Palazzo Uguccioni	LOC
Piazza della Signoria	LOC
Giovanni Uguccioni	PER
1550	TIME
Raphael	PER
Michelangelo	PER
Andrea Palladio	PER
Bartolomeo Ammannati	PER
Raffaello da Montelupo	PER
1549	TIME
Bramante	PER
Corithian	MISC
Francesco I de' Medici	PER
Giambologna	PER
Google Sheets	MISC
Google Drive	MISC
Google Docs	MISC
Google Slides	MISC
Windows	MISC
BlackBerry	MISC
ChromeOS	MISC
Microsoft	ORG
Excel	MISC
Explore	MISC
Liberation of Bulgaria	MISC
Provisional Russian Administration	ORG
Chairman of the City Administrative Council	ORG
City Administrative Council	ORG
Tsar	PER
Internal Affairs	ORG
Chairman of the Executive Committee	ORG
Executive Committee	ORG
People 's Council	ORG
Bulgarian Communist Party	ORG
7th Grand National Assembly	MISC
Aleksandar Karakachanov	PER
Aleksandar Yanchulev	PER
13 October 1991	TIME
High Commissioner from New Zealand to Fiji	MISC
Republic of the Fiji Islands	LOC
High Commission	ORG
Suva	LOC
Head of Mission	ORG
Nauru	LOC
Tuvalu	LOC
Commonwealth of Nations	ORG
Heads of State	MISC
High Commissioners	MISC
James Manuel Costa	PER
April 13, 1952	TIME
California State Assembly	ORG
State Senate	ORG
California State Legislature	ORG
26	NUM
Latino	ORG
Fresno	LOC
Blue Dog Coalition	ORG
United States House Agriculture Subcommittee on Rural Development , Research , Biotechnology , and Foreign Agriculture	ORG
Myre	PER
NPR	ORG
Associated Press	ORG
New York Times	ORG
Nicosia	LOC
Islamabad	LOC
Johannesburg	LOC
Nelson Mandela	PER
Gulf War	MISC
Taliban	ORG
Vladimir Putin	PER
Palestinian	LOC
Afghanistan	LOC
Middle East Institute	ORG
Ames Laboratory	ORG
United States Department of Energy	ORG
Ames	LOC
Iowa State University	ORG
January 2013	TIME
Department of Energy	ORG
CMI	ORG
Aleksandr Solomonovich Khakhanov	PER
Aleksandre Khakhanashvili	PER
January 3 , 1864	TIME
May 25 , 1912	TIME
Georgian	LOC
Gori	LOC
Georgia	LOC
Tbilisi Gymnasium	ORG
Moscow University	ORG
Lazarev Institute of Oriental Languages	ORG
Очерки по истории грузинской словесности	MISC
1895	TIME
1907	TIME
Histoire de Géorgie	MISC
Moscow Imperial Archeological Society	ORG
Georgian Historic and Ethnographic Society	ORG
Mükemmel	MISC
Turkish	LOC
Hande Yener	PER
June 2, 2014	TIME
Poll Production	ORG
Ask Kadin Ruhundan Anlamiyor	MISC
Apayri	MISC
Nasil Delirdim	MISC
iTunes	MISC
Karar Ver	MISC
Naber	MISC
Kaybol	MISC
Alt Dudak	MISC
R&B	MISC
Embedded Visual Basic	MISC
Microsoft Visual Basic	MISC
PDAs	MISC
Windows CE	MISC
Windows 98	MISC
Windows NT	MISC
Windows XP	MISC
Embedded Visual C++	MISC
Microsoft Visual C++	MISC
Embedded Visual J++	MISC
Visual FoxPro	MISC
ActiveSync	MISC
Control Panel	MISC
Install & Uninstall Programmes	MISC
RegEdit	MISC
Microsoft Office	MISC
Pocket	MISC
Embedded Visual InterDev	MISC
MSDN	MISC
Visual Source Safe	MISC
Visual Basic	MISC
Windows Script Host	MISC
CD - Rom	MISC
Visual J++	MISC
Visual C++	MISC
Visual Basic 6.0	MISC
Visual J++ 6.0	MISC
Visual C++ 6.0	MISC
CD - Roms	MISC
.NET	MISC
Microsoft One Basic	MISC
NS BASIC	MISC
Clarence Profit	PER
June 26 , 1912	TIME
October 22 , 1944	TIME
Antigua	LOC
Bermuda	LOC
Lullaby In Rhythm	MISC
Edgar Sampson	PER
Linda Karen Reynolds	PER
16 May 1965	TIME
Australian Senate	ORG
Western Australia	LOC
1 July 2014	TIME
Liberal Senate	ORG
High Court	ORG
Federal Liberal Party	ORG
Australian Army Reserve	ORG
Chris Ellison	PER
Conspicuous Service Cross	MISC
2011 Australia Day Honours	MISC
Army Strategic Reform Program	MISC
Alfred Reynolds	PER
Labor Party	ORG
Western Australian Legislative Assembly	ORG
Penny Sue Pritzker	PER
May 2, 1959	TIME
Barack Obama	PER
Commerce	ORG
97–1	NUM
Jay Pritzker	PER
PSP Capital Partners	ORG
Pritzker Realty Group	ORG
Artemis Real Estate Partners	ORG
October 2015	TIME
$2.4 billion	NUM
Chicago Board of Education	ORG
Museum of Contemporary Art	ORG
Pritzker Traubert Family Foundation	ORG
Royal Victorian Order	MISC
Commonwealth	ORG
Royal Household	ORG
23 April 1896	TIME
Great Seal of the Realm	MISC
Knight Grand Cross	MISC
Knight Commander	MISC
Commander	MISC
LVO	MISC
Member ( fifth class )	MISC
MVO	MISC
Dames	MISC
Dame Grand Cross	MISC
Dame Commander	MISC
Sir	MISC
Pacific Fair	LOC
Broadbeach Waters	LOC
Gold Coast	LOC
Hooker Retail Developments	ORG
January 2014	TIME
Myer	ORG
Kmart	ORG
Coles	ORG
Toys ' R ' Us	ORG
Daimaru	ORG
12-screen	NUM
Birch Carroll and Coyle Cinema	ORG
Event Cinemas	ORG
late 2015	TIME
Surfside Buslines	ORG
Broadbeach South station	LOC
Star Gold Coast	LOC
Gold Coast Convention & Exhibition Centre	LOC
Little Tallebudgera Creek	LOC
Surfers Riverwalk	LOC
The Mole	MISC
John Small	PER
August 27 , 1746	TIME
July 18 , 1831	TIME
Upper Canada	LOC
Cirencester	LOC
1746	TIME
Executive Council of Upper Canada	ORG
John Graves Simcoe	PER
York	LOC
Charles Small	PER
Berkeley House	LOC
January 1800	TIME
John White	PER
White	PER
Henry Allcock	PER
James Edward	PER
Province of Canada	LOC
Charles Coxwell Small	PER
Parliaments	ORG
Parliaments of the Province of Canada	ORG
Dominion of Canada	LOC
Bidet	MISC
Morvan	LOC
Auvergne	LOC
Poitou	LOC
Burgundy	LOC
110–135 centimetres	NUM
Ventadour Lake	LOC
Eeyou Istchee James Bay	LOC
Jamésie	LOC
Nord-du-Québec	LOC
Ventadour	LOC
Feuquières	LOC
Lake Ventadour	LOC
forest road R1032	LOC
Gabriel and Ventadour	LOC
Ventadour River	LOC
route 212	LOC
Obedjiwan	LOC
La Tuque	LOC
November	TIME
mid - May	TIME
mid - November	TIME
mid - April	TIME
Zhangping – Quanzhou – Xiaocuo railway	LOC
Zhangquanxiao railway	LOC
Fujian Province	LOC
Zhangping	LOC
Quanzhou	LOC
Xiaocuo Harbor	LOC
Port of Quanzhou	LOC
Xiaochuo Harbor	LOC
Quanzhou East	LOC
December 9, 2014	TIME
Xiamen	LOC
Vans Warped Tour	MISC
Vans	ORG
Kevin Lyman	PER
2018 Vans Warped Tour	MISC
Standard Oil Co. Inc.	ORG
1870	TIME
Rockefeller	PER
Henry Flagler	PER
United States Supreme Court	ORG
Standard Oil	MISC
Trust - busting	MISC
ExxonMobil	ORG
Chevron	ORG
1882	TIME
John Dustin Archbold	PER
Florida East Coast Railway	LOC
Henry H. Rogers	PER
Virginian Railway	LOC
New Armenian Resistance	MISC
Switzerland	LOC
Brussels	LOC
Turkish Airlines	ORG
February 1983	TIME
Armenian Secret Army for the Liberation of Armenia	ORG
Luke Schenn	PER
November 2, 1989	TIME
Anaheim Ducks	ORG
National Hockey League	ORG
Schenn	PER
Kelowna Rockets	ORG
Western Hockey League	ORG
League	ORG
Second All - Star Team	MISC
2008 NHL Entry Draft	MISC
Toronto Maple Leafs	ORG
09	TIME
Maple Leafs	ORG
2011–12	TIME
All-Rookie Team	ORG
2008 World Junior Ice Hockey Championships	MISC
2009 World Ice Hockey Championships	MISC
Luke 's Troops	ORG
Brayden	PER
St. Louis Blues	ORG
Slivo Pole	LOC
Rousse Province	LOC
Slivo Pole Municipality	LOC
five kilometres	NUM
Danube	LOC
Silistra	LOC
December 2009	TIME
3,169	NUM
29 November 2002	TIME
Tatars	ORG
Crimean War	MISC
1853	TIME
Zlatni Rat	LOC
Golden Cape	LOC
Golden Horn	LOC
Chakavian dialect	MISC
Bol	LOC
Croatian	LOC
Brač	LOC
Dalmatia	LOC
Hvar Channel	LOC
Adriatic Sea	LOC
Hvar	LOC
Mediterranean	LOC
Patrick Martin	PER
May 23, 1983	TIME
Impact Wrestling	MISC
one half	NUM
The Motor City Machine Guns	MISC
Chris Sabin	PER
Ring of Honor	MISC
Zero1-Max	PER
New Japan Pro - Wrestling	ORG
three - time	NUM
IWGP Junior Heavyweight Tag Team Champion	MISC
The High Crusade	ORG
Petey Williams	PER
Robert McDougall	PER
16 April 1813	TIME
25 June 1887	TIME
Victorian Legislative Assembly	ORG
Fortingall	LOC
Perthshire	LOC
Alexander McDougall	PER
Grace	PER
November 1841	TIME
November 1856	TIME
West Bourke	LOC
August 1857	TIME
Arundel	LOC
Keilor	LOC
Booth	MISC
Bates	MISC
Niel Black	PER
Ellora	LOC
Moonee Ponds	LOC
